Wo, Wo, Wo, Wo, Wo, Wo, Ww, Wo, Wo, Wo, Wo, Wo, Wo, Wo, Wo, Wo, Wo, Wo, Wo, Wo, Wo, Wo, Wo, Wo, Wo, Wo, Wo, Wo, Wo, Wo, Wo, Wo, Wo, Wo
Wo, Wo, Wo, Wo, Ww, Ww, Ww, Ww, Ww, Wo, Ww, Wo, Wo, Wo, Wo, Wo, Ww, Wo, Ww, Wo, Wo, Wo, Wo, Wo, Wo, Wo, Wo, Wo, Wo, Wo, Wo, Wo, Wo, Wo
Wo, Wo, Wo, Ww, Ds, Ds, Ds, Ds, Ds, Ww, Ww, Ww, Ww, Ww, Ww, Ww, Ww, Ww, Ww, Ww, Ww, Wo, Ww, Wo, Wo, Wo, Wo, Wo, Wo, Wo, Wo, Wo, Wo, Wo
Wo, Wo, Ww, Ww, Ds, Gg, Gg, Ds, Gg, Ds, Ds, Ww, Ds, Ds, Ds, Ww, Ds, Ds, Ds, Ww, Ds, Ww, Ww, Ww, Ww, Wo, Wo, Wo, Wo, Wo, Wo, Wo, Wo, Wo
Wo, Wo, Wo, Ww, Ds, Gs, Gs^Em, Gs, Gs^Em, Gg, Gg, Ds, Gg, Gg, Gg, Ds, Gg, Gg, Gg, Ds, Gg, Ds, Ds, Ww, Ww, Wo, Wo, Wo, Wo, Wo, Wo, Wo, Wo, Wo
Wo, Wo, Ww, Ww, Ds, Gg, Gs^Fmw, Gs^Fmw, Gs^Fmw, Gs^Fmw, Gs^Fmw, Gs^Fmw, Gs^Fmw, Gs^Fmw, Gs^Fmw, Gs^Vl, Gs^Fmw, Gs^Fmw, Gs^Fmw, Gs, Gg, Gs^Fms, Gs^Fms, Ds, Ww, Ww, Wo, Wo, Wo, Wo, Wo, Wo, Wo, Wo
Wo, Ww, Ww, Ww, Ds, Gs^Fmw, Gs^Fmw, Gs^Fmw, Gs^Fmw, Gs^Fmw, Cer, Cer, Cer^Edt, Gg^Fet, Gs^Fmw, Gs^Fmw, Gs^Fmw, Gs^Fmw, Gs^Fmw, Gs^Fmw, Gg, Gs^Fms, Gg^Fet, Ds, Ww, Ww, Ww, Ww, Ww, Ww, Ww, Wo, Wo, Wo
Wo, Wo, Wo, Ww, Ds, Gg^Efm, Gs^Fmw, Gs^Fmw, Gg^Ve, Gs^Fmw, Cer, 2 Ker, Cer^Edt, Gs^Fmw, Gg^Edt, Gs^Fmw, Gg^Em, Gs^Fmw, Gs^Fmw, Gs^Fmw, Gg, Gg, Ds, Ds, Ww, Ww, Ds, Ds, Ds, Ww, Ww, Ww, Ww, Wo
Wo, Wo, Ww, Ww, Ww, Ds, Gg, Gs^Fmw, Gs^Fmw, Gs^Fmw, Gg^Efm, Cer^Edt, Gg^Efm, Gg^Efm, Gg^Efm, Gs, Gs^Em, Gg, Gg, Gg, Gg, Gg, Ww, Ww, Ds, Ds, Gg, Gg, Gs^Fms, Ds, Ds, Ww, Ww, Wo
Wo, Wo, Ww, Ww, Ww, Ds, Gg, Gs^Fmw, Gs^Fmw, Gs^Fmw, Gg, Gg^Efm, Gg^Efm, Gg^Efm, Gg^Efm, Gs, Gg, Gg, Gs^Fms, Gg, Gg, Ww^Es, Ww, Gg, Gg, Gg, Gs^Fms, Gs^Es, Gs^Fms, Gs^Vc, Ds, Ww, Ww, Wo
Wo, Wo, Ww, Ww, Ds, Ds, Gg, Gg^Fet, Gs^Fmw, Gs^Fmw, Gs^Vh, Gg, Gg^Efm, Gg^Efm, Gs^Fms, Gg, Gs^Vl, Gs^Fms, Gs^Fms, Gg, Ww, Ww, Gs^Fms, Gg^Fet, Gs^Fms, Gs^Fms, Ce, Ce, Ce, Gs^Fms, Ds, Ww, Ww, Ww
Wo, Ww, Ww, Ds, Gs, Ds, Gg^Fet, Gg^Fet, Gs^Fmw, Gs^Fmw, Gg, Gg, Gg^Edt, Gs^Fms, Gs^Fms, Gs^Fms, Gs^Fms, Gs^Fms, Gg^Efm, Ww, Ww, Gg^Efm, Gs^Fms, Gs^Fms, Gg^Efm, Gg^Efm, Ce, 3 Ket, Ce, Gs^Fms, Gs^Fms, Ds, Ww, Wo
Wo, Ww, Ww, Ds, Gg, Gg, Gs^Fmw, Gs^Fmw, Gs^Fmw, Gs^Fmw, Gs^Fmw, Gg, Gg, Gs^Fms, Gs^Fms, Gs^Fms, Gs^Fms, Gg^Efm, Ww, Gg^Efm, Ww, Gg^Efm, Gs^Fms, Gs^Vh, Gg^Efm, Gg^Efm, Gs^Fms, Ce, Gs^Fms, Gs^Fms, Gs^Fms, Ds, Ww, Ww
Wo, Wo, Ww, Ds, Gg, Gs^Vc, Gs^Fmw, Gs^Fmw, Gs^Fmw, Gs^Fmw, Gs^Fmw, Gg^Efm, Gg, Gs^Fms, Gs^Fms, Gs^Fms, Gg^Efm, Gg^Efm, Ww, Ww, Gg^Efm, Gg^Efm, Gg^Efm, Gg^Efm, Gs^Fms, Gs^Fms, Gs^Fms, Gs^Fms, Gs^Fms, Gs^Fms, Gg, Ds, Ds, Ww
Wo, Wo, Ww, Ds, Ds, Gs^Fmw, Gs^Fmw, Gs^Fmw, Gs^Fmw, Gs^Fmw, Gg^Efm, Gg^Efm, Gg, Gs^Fms, Gs^Fms, Gg^Efm, Ww, Ww, Gg^Efm, Gg^Efm, Gs^Fds, Gg^Efm, Gg^Efm, Gs^Fms, Gs^Fms, Gs^Fms, Gg, Gs, Gs, Gs^Fms, Gg^Es, Gs, Gg, Ds
Wo, Wo, Ww, Ww, Ds, Gg^Efm, Gg^Em, Gs^Fmw, Gs^Fmw, Gg^Efm, Gg^Efm, Gs^Fms, Gs^Fms, Gs^Fms, Gg^Efm, Gg^Efm, Ww, Gg^Efm, Gg^Fet, Gg^Fet, Gs^Fds, Gs^Vc, Gg, Gg, Ww^Es, Gg, Ww, Gg, Gg, Gg, Gs^Vl, Gg, Gs^Fmw, Gg
Wo, Ww, Ww, Ds, Gg^Efm, Gg^Efm, Gs^Fmw, Gs^Fmw, Gs^Fmw, Gg^Efm, Gs^Vc, Gs^Fms, Gs^Fms, Gs^Fms, Gg^Efm, Ww, Gg^Efm, Gg^Efm, Gg^Efm, Gg^Fet, Gg^Fet, Gg, Ww, Ww, Ww, Ww, Gg, Ww, Ww, Gg, Gg, Gs^Fmw, Gs^Fmw, Gg^Fet
Wo, Ww, Ww, Ds, Ds, Gg^Efm, Gg^Efm, Gg^Efm, Gg^Efm, Gg^Efm, Gg^Efm, Gg^Efm, Gg^Efm, Gg^Efm, Ww^Es, Ww, Ww, Gg^Efm, Ww, Gg^Efm, Ww, Ww, Gg^Efm, Gg^Efm, Gs^Fmw, Gg, Gs, Gs, Ww, Ww, Gs, Gg, Gs^Fmw, Gs^Fmw
Wo, Wo, Wo, Ww, Ds, Gg^Efm, Gg^Efm, Gs^Fmw, Gs^Fmw, Gg^Efm, Gs^Fmw, Gg^Efm, Gg^Efm, Gg^Efm, Gg^Efm, Ww, Gg^Efm, Ww, Gg^Efm, Ww, Gg^Efm, Gg^Efm, Gs^Fmw, Gs^Fmw, Gs^Fmw, Gs^Fmw, Gs^Fmw, Gs, Gg, Ww, Ww, Ww, Ww, Ww
Wo, Wo, Wo, Ww, Ww, Ds, Ds, Gs^Fmw, Gs^Fmw, Gs^Fmw, Gs^Fmw, Gs^Fmw, Gg^Fet, Gg^Efm, Gg^Fet, Gg^Efm, Gg^Efm, Gg^Efm, Gg^Efm, Gg^Efm, Gs^Fmw, Gs^Fmw, Gs^Fmw, Gs^Fmw, Gs^Fmw, Gs^Fmw, Gs^Fmw, Gs, Gg^Es, Gg, Gs, Gg, Gg, Gg
Wo, Wo, Ww, Ww, Ww, Ds, Gg, Gs, Gs^Fmw, Gs^Fmw, Gs^Fmw, Gs^Fmw, Gg^Fet, Gg^Fet, Gg^Efm, Gg^Efm, Gs^Fmw, Gg^Efm, Gg^Efm, Gg^Efm, Gg^Efm, Gs^Vl, Gg, Gs^Fmw, Gs^Fmw, Gs^Fmw, Gs^Fmw, Gs^Fmw, Gs^Fmw, Gs^Fmw, Gs^Fmw, Gs^Fmw, Gs^Fmw, Gs^Fmw
Wo, Wo, Ww, Ww, Ww, Ds, Gg, Gs, Gs^Fmw, Gs^Fmw, Gs^Fmw, Gs^Fmw, Gg^Fet, Gg^Efm, Gg^Efm, Gs^Fmw, Gs^Fmw, Gs^Fmw, Gg^Efm, Gg^Efm, Gg^Efm, Gg^Efm, Gg^Efm, Gs^Fmw, Gg, Gs^Fmw, Gs^Fmw, Gs^Fmw, Gs^Fmw, Gs^Fmw, Gs^Fmw, Gs^Fmw, Gs^Fmw, Gs^Fmw
Wo, Ww, Ds, Ds, Gg, Ww, Ww, Gg, Gs^Vl, Gs^Fmw, Gs^Fmw, Gs^Fmw, Gg^Fet, Gs^Fmw, Gg^Efm, Gs^Fmw, Gs^Fmw, Gs^Fmw, Gg^Efm, Gg^Efm, Gg^Efm, Gg^Efm, Gg, Gg, Gg, Gg^Em, Gs^Fmw, Gs^Fmw, Gs^Fmw, Gs^Fmw, Gs^Fmw, Gs^Fmw, Gs^Fmw, Gs^Fmw
Ww, Ww, Ds, Ds, Gg, Ww, Ww, Ww, Gg, Gs^Fmw, Gs^Fmw, Gg^Fet, Gs^Fmw, Gs^Fmw, Gg^Efm, Gg^Efm, Gs^Fmw, Gs^Fmw, Gs^Fmw, Gg, Gg, Gg, Gg, Gs^Vh, Gs^Fmw, Gs^Fmw, Gs^Fmw, Gs^Fmw, Gs^Fmw, Gg, Gs^Vc, Gg, Gg, Gs^Fmw
Ds, Ds, Gs^Fms, Gg, Gs^Fms, Gg, Ww^Es, Ww, Ww, Gs^Fmw, Gs^Fmw, Gs^Fmw, Gs^Fmw, Gg^Efm, Gg^Efm, Gs^Vc, Gs^Fmw, Gs^Fmw, Gs^Fmw, Gg, Ce, Ce, Ce, Gs^Fmw, Gs^Fmw, Gg^Fet, Gs^Fmw, Gs^Fmw, Gs^Fmw, Gg, Gs^Fmw, Gg, Gs^Fmw, Gg
Gg, Gs^Fms, Gs^Fms, Gs^Fms, Gs^Fms, Gg, Gg, Ww, Ww, Gg, Ww^Es, Gs^Fmw, Gs^Fmw, Gs^Fmw, Gs^Fmw, Gs^Fmw, Gs^Fmw, Gs^Fmw, Gg, Gg, Ce, 1 Ket, Ce, Gs^Fmw, Gs^Fmw, Gs^Fmw, Gs^Fmw, Gs^Fmw, Gs^Fmw, Gg, Gs^Fmw, Gs^Fmw, Gs^Fmw, Gg
Gg, Gs^Fms, Gs^Fms, Gg^Fet, Gs^Fms, Gg, Gs^Fmw, Gg, Gg, Ww, Ww, Gs^Fmw, Gs^Fmw, Gs^Fmw, Gs^Fmw, Gs^Fmw, Gs^Fmw, Gs^Fmw, Gs^Fmw, Gg, Gg, Ce, Gs^Fmw, Gs^Fmw, Gs^Fmw, Gs^Fmw, Gs^Fmw, Gs^Fmw, Gg, Gg, Gs, Gs^Fmw, Gs^Fmw, Gg
Gg, Gs^Vh, Gg, Gg, Gs, Gg, Gs^Fmw, Gs^Vc, Gg, Ww, Ww, Gs^Fmw, Gs^Fmw, Gs^Fmw, Gs^Fmw, Gs^Fmw, Gs^Fmw, Gs^Fmw, Gs^Fmw, Gg^Ve, Gs^Fmw, Gs^Fmw, Gs^Fmw, Gs^Fmw, Gs^Fmw, Gs^Fmw, Gg, Gg, Gs^Fms, Gg, Gg, Gs^Fmw, Gg, Gs^Fmw
Gs^Fmw, Gg, Gg, Gs^Em, Gg^Es, Gs^Es, Gs^Fmw, Gs^Fmw, Gs^Fmw, Gg, Ww, Gg, Gg, Gs^Fmw, Gs^Fmw, Gs^Fmw, Gs^Fmw, Gs^Fmw, Gs^Fmw, Gs^Fmw, Gg, Gs^Fmw, Gs, Gs, Gg, Gg, Gs^Fms, Gs^Fms, Gs^Fms, Gs^Fms, Gg^Fet, Gg, Gg^Fet, Gg
Gs^Fmw, Gs^Fmw, Gs^Fmw, Gs^Fmw, Gs^Fmw, Gs^Fmw, Gs^Fmw, Gs^Fmw, Gs^Fmw, Gs^Fmw, Gg^Efm, Ww, Ww, Gg, Gs, Gg^Fet, Gs^Es, Gs^Fmw, Gg, Gg, Gs^Fms, Gg, Gg, Gs, Gs^Fms, Gg, Gg, Gs^Fms, Gs^Fms, Gs^Fms, Gg^Fet, Gg^Fet, Gg^Fet, Gg^Fet
Gs^Fmw, Gs^Fmw, Gs^Fmw, Gs^Fmw, Gs^Fmw, Gs^Fmw, Gs^Fmw, Gs^Fmw, Gs^Fmw, Gg^Efm, Gg^Efm, Ww, Ww, Gg, Gg, Gs, Gg, Gg, Gg, Gs^Fms, Gg, Gs^Fms, Gs^Fms, Gs^Fms, Gs^Fms, Gs^Fms, Gs^Fms, Gg^Ve, Gg^Efm, Gg^Fet, Gs^Fms, Gs^Fms, Gs^Fms, Gs^Fms
Gg, Gs^Fmw, Gs^Fmw, Gs^Fmw, Gs^Fmw, Gs^Fmw, Gg^Fet, Gs^Fmw, Gg^Ve, Gs^Fmw, Gg^Efm, Ww, Ww, Ww, Ww, Ww, Ww, Ww, Ww, Gg, Gg, Gs^Fms, Gs^Fms, Gs^Fms, Gs^Fms, Gs^Fms, Gs^Fms, Gs^Fms, Gg^Efm, Gg^Fet, Gs^Fms, Gs^Fms, Gs^Fms, Gs^Fms
Gs^Fmw, Gs^Fmw, Gs^Fmw, Gs^Fmw, Gs^Fmw, Gs^Fmw, Gs^Fmw, Gg^Fet, Gs^Fmw, Gs^Fmw, Gs^Fmw, Gs^Fmw, Gs^Fmw, Gg, Gg, Gg, Gg^Es, Ww, Gg, Ww, Ww, Ww^Es, Ww, Gg^Efm, Gg^Efm, Gs^Fms, Gs^Fms, Gg^Efm, Gll^Fp, Gs^Fms, Gs^Fms, Gs^Fms, Gs^Fms, Gs^Fms
Gg, Gs^Fmw, Gs^Fmw, Gs^Fmw, Gs^Fmw, Gs^Fmw, Gg, Gs^Fmw, Gg, Gs^Fmw, Gs^Fmw, Gs^Fmw, Gs^Fmw, Gs^Fmw, Gg, Gg, Gg, Gg, Gg, Gg, Gg, Ww, Ww, Gg^Efm, Gg^Efm, Gg^Efm, Gg^Efm, Gg^Efm, Gg^Efm, Gs^Fms, Gs^Fms, Gs^Fms, Gs^Fms, Gs^Fms
