Wo, Wo, Wo, Wo, Wo, Wo, Wo, Wo, Wo, Wo, Wo, Wo, Wo, Wo, Wo, Wo, Wo, Wo, Wo, Wo, Wo, Wo, Wo, Wo, Wo, Wo, Wo, Wo, Wo, Wo
Wo, Wo, Wo, Wo, Wo, Wo, Wo, Wo, Wo, Wo, Wo, Wo, Wo, Wo, Wo, Wo, Wo, Wo, Wo, Wo, Ww, Wo, Ww, Wo, Wo, Wo, Wo, Wo, Wo, Wo
Wo, Wo, Wo, Wo, Wo, Wo, Ww, Ww, Ww, Wo, Wo, Wo, Wo, Wo, Wo, Wo, Ww, Ww, Ww, Ww, Ww, Ww, Ww, Ww, Wo, Wo, Wo, Wo, Wo, Wo
Wo, Wo, Wo, Wo, Ww, Wo, Ww, Ww, Ww, Ww, Ww, Wo, Wo, Ww^Vm, Wo, Ww, Ww, Gs^Ftp, Gs^Ftp, Ds, Ds, Ww, Ww, Ww, Ww, Wo, Wo, Wo, Wo, Wo
Wo, Wo, Wo, Wo, Ww, Ww, Gs^Ftp, Gs^Ftp, Ww, Ww, Ww, Ww, Wo, Wo, Ww, Ww, Ww, Gs^Ftp, Gs^Ftp, Gs^Ftp, Gs^Ftp, Gs^Ftp, Ds, Ww, Ww, Ww, Ww, Wo, Wo, Wo
Wo, Wo, Wo, Ww, Ww, Ds, Dd^Vda, Gs^Ftp, Ww, Wo, Wo, Wo, Ww, Ww, Ww, Ww, Ds, Ds, Gs^Ftp, Ce, 1 Ket, Gs^Ftp, Gs^Ftp, Ww, Ww, Ww, Ww, Wo, Wo, Wo
Wo, Wo, Wo, Ww, Ww, Ww, Ww, Ww, Ww, Wo, Ww, Ww, Dd^Vda, Gs^Ftp, Ww, Ww, Gs^Ftp, Gs^Ftp, Gs^Ftp, Ce, Ce, Gs^Ftp, Gs^Vht, Ds, Ww, Ww, Wo, Wo, Wo, Wo
Wo, Wo, Ww, Ww, Ww, Ww, Ww, Ww, Wo, Wo, Ww, Ds, Gs^Ftp, Gs^Ftp, Ww, Ww, Ww, Gs^Ftp, Ds, Gs^Ftp, Ds, Gs^Ftp, Gs^Ftp, Gs^Ftp, Ww, Ww, Wo, Wo, Wo, Wo
Wo, Wo, Ww, Ww, Ww, Ww, Ww, Ww, Ww, Wo, Wo, Ww, Ww, Ww, Ww, Ww, Ww, Ww, Ww, Ww, Ww, Ds, Gs^Ftp, Gs^Ftp, Ww, Ww, Wo, Wo, Wo, Wo
Wo, Wo, Ww, Ww, Ww, Ww, Ww, Ww, Ww, Ww, Wo, Ww, Ww, Ww, Gs^Ftp, Ww, Ww, Ww, Wo, Ww, Ww, Ww, Ww, Ww, Ww, Wo, Ww^Vm, Wo, Wo, Wo
Wo, Ww, Ds, Ds, Cme, Cme, Cme, Ww, Ww, Ww, Wo, Wo, Ww, Gs^Ftp, Gs^Ftp, Gs^Ftp, Ds, Ww, Ww, Wo, Ww, Ww, Ww, Ww, Wo, Wo, Wo, Wo, Wo, Wo
Wo, Ww, Ds, Gs^Ftp, Gs^Ftp, 2 Kme, Gs^Ftp, Ds, Ww, Ww, Ww^Vm, Wo, Ww, Ds, Gs^Ftp, Dd^Vda, Ds, Ww, Wo, Wo, Ww, Ww, Dd^Vda, Ww, Ww, Ww, Wo, Wo, Wo, Wo
Wo, Ww, Ww, Ds, Gs^Ftp, Gs^Ftp, Gs^Vht, Gs^Ftp, Ww, Ww, Wo, Wo, Wo, Ww, Ww, Gs^Ftp, Ww, Ww, Ww, Wo, Ww, Ww, Ds, Gs^Ftp, Ww, Ww, Wo, Wo, Wo, Wo
Wo, Wo, Ww, Ds, Gs^Ftp, Gs^Ftp, Ds, Gs^Ftp, Ww, Ww, Ww, Ww, Ww, Wo, Ww, Ww, Ww, Ww, Ww, Wo, Wo, Ww, Ww, Ww, Ww, Ww, Wo, Wo, Wo, Wo
Wo, Wo, Ww, Ww, Ww, Ds, Ww, Ww, Ww, Ww, Dd^Vda, Ds, Gs^Ftp, Ww, Ww, Ww, Ww, Ww, Ds, Ww, Ww, Wo, Ww, Ww, Ww, Wo, Ww, Wo, Wo, Wo
Wo, Wo, Ww, Ww, Wo, Ww, Wo, Ww, Ww, Ww, Ww, Gs^Ftp, Ww, Ww, Ww, Ww, Gs^Ftp, Gs^Ftp, Gs^Ftp, Ds, Gs^Vht, Ww, Ww, Ww, Ww, Ww, Ww, Wo, Wo, Wo
Wo, Wo, Ww, Ww, Wo, Wo, Ww, Ww, Ww, Ww, Ww, Ww, Ww, Ww, Ww, Ww, Gs^Ftp, Gs^Ftp, Gs^Ftp, Gs^Ftp, Gs^Ftp, Gs^Ftp, Gs^Ftp, Ww, Wo, Ww, Wo, Wo, Wo, Wo
Wo, Wo, Wo, Wo, Wo, Ww, Ds, Dd^Vda, Ds, Ww, Ww, Ww, Ww, Ww, Ww, Ww, Ww, Cme, 3 Kme, Gs^Ftp, Ds, Gs^Ftp, Ds, Ww, Ww, Wo, Wo, Wo, Wo, Wo
Wo, Wo, Wo, Wo, Ww, Ww, Ww, Gs^Ftp, Gs^Ftp, Gs^Ftp, Ww, Ww, Wo, Ww, Wo, Wo, Ww, Cme, Cme, Gs^Ftp, Ds, Ww, Ww, Ww, Ww, Wo, Wo, Wo, Wo, Wo
Wo, Wo, Wo, Ww, Ww, Ww, Ww, Ww, Ww, Ww, Ww, Wo, Wo, Ww^Vm, Wo, Wo, Ww, Ww, Ww, Ds, Ww, Ww, Wo, Ww, Wo, Ww^Vm, Wo, Wo, Wo, Wo
Wo, Wo, Wo, Ww, Wo, Ww, Wo, Ww, Wo, Ww, Ww, Ww, Wo, Wo, Wo, Ww, Wo, Ww, Ww, Ww, Ww, Wo, Wo, Wo, Wo, Wo, Wo, Wo, Wo, Wo
Wo, Wo, Wo, Wo, Wo, Wo, Wo, Wo, Wo, Wo, Wo, Wo, Wo, Wo, Wo, Wo, Wo, Wo, Wo, Wo, Wo, Wo, Wo, Wo, Wo, Wo, Wo, Wo, Wo, Wo
Wo, Wo, Wo, Wo, Wo, Wo, Wo, Wo, Wo, Wo, Wo, Wo, Wo, Wo, Wo, Wo, Wo, Wo, Wo, Wo, Wo, Wo, Wo, Wo, Wo, Wo, Wo, Wo, Wo, Wo
