Ss, Ss, Ss, Ww, Ww, Ww, Ww, Gs^Fp, Gs^Fp, Ss, Ss, Ss, Ss, Ss, Ss, Ss, Gs^Fms, Gs, Gg^Es, Ss^Emf, Ss^Emf, Ss^Emf, Gg^Es, Ss^Emf, Ss^Emf, Ss^Emf, Mm, Mm, Mm, Mm, Mm, Ss, Mm, Mm^Em, Hh^Em, Ss
Gs^Fp, Gs^Fp, Ss, Ss, Ww, Ww^Es, Gg^Ve, Re, Re^Em, Ss, Ss, Ss, Ss, Ss, Ss, Ss, Gg, Gg^Es, Gs, Ss^Emf, Gs, Ss^Emf, Ss^Emf, Ss^Emf, Ss^Emf, Hh, Hh, Mm, Hh^Es, Mm, Hh^Em, Mm, Hh, Hh^Em, Hh, Ss
Ss, Ss, Ss, Sm, Gs^Fp, Ww, Gs^Fp, Gs^Fp, Ww^Bw|, Ss, Ss, Ss, Ss^Emf, Ss^Emf, Ss^Emf, Ss^Emf, Gs, Gg^Edt, Gs^Efm, Gs, Gg, Ss^Emf, Ss^Emf, Gs^Fp, Ss^Emf, Hh, Hh, Hh, Hh, Hh, Ss, Hh, Hh, Hh, Ss, Gs^Fp
Gg, Ss, Ss, Ww, Gs^Fp, Ww, Ww, Ss, Chr, Ss, Ss, Ss, Ss, Ss, Ss^Emf, Ss^Emf, Gs^Fms, Gs, Sm, Gs, Ss^Emf, Ss^Emf, Gs^Fp, Gs^Fp, Gs^Fp, Gs^Fp, Gs^Fp, Gs^Fp, Ss, Ss, Ss, Ss, Ss, Ss, Ss, Ss
Ss, Ss, Gs^Fp, Gs^Fp, Ww, Gs^Fp, Ww, Ww^Bw|, Ww, Re, Ss, Ss, Ss, Ss, Ss, Ss, Gs^Fms, Sm, Sm, Gs^Fms, Ss, Ss, Gs^Vh, Gs^Fp, Gs^Fp, Gg^Ve, Gs^Fp, Gs^Fp, Ss, Ss, Ss, Ss, Ss, Ss, Gs^Fms, Gs^Fms
Ss, Gs^Fp, Gs^Fp, Ss, Ss, Ss, Ww, Ww, Ww, Re, Re, Gg^Efm, Gg, Chr^Ecf, Ss, Ss, Ss, Sm, Sm, Sm, Sm, Ss, Ss, Ss, Gs^Fp, Gs^Fp, Gs^Fp, Ss, Ss, Gg, Gs^Fms, Gs, Gs, Gs, Gg, Gs^Fms
Ss, Ss, Ss, Ss, Chr, Gs^Fp, Ww, Ww, Ww, Ss^Vhs, Re, Gg, Chr^Ecf, Chr^Ecf, Gg, Ss, Ss, Ss, Ss, Sm, Sm, Sm, Gg, Ss, Gs^Fms, Ss, Ss, Ss, Gs^Fms, Gs^Fms, Gs^Fms, Gg, Gs, Gs^Efm, Gg, Gs^Fms
Gg, Gg, Ss, Chr, 2 Khr, Chr, Mm, Mm, Mm, Ww, Ww, Ww, Ww, Ww, Ww, Gs^Vh, Ss, Ss, Ww, Ss, Gs^Fms, Gs, Gs^Fms, Gs, Chr, Gs, Gs^Fms, Ss, Gs^Fms, Gs^Fms, Gg, Gs^Fms, Gs^Fms, Gg, Gs^Fms, Gs^Fms
Gg, Gg^Ve, Gg^Edt, Chr, Chr, Chr^Edt, Mm, Mm, Mm, Mm, Hh, Ww, Ww, Ww^Es, Ww, Ww, Ww, Ww, Ww, Ww, Ww, Gs, Gs^Fms, Chr^Edt, Khr, Chr, Gs, Gg^Edt, Gs^Fms, Gs^Fms, Gs^Fms, Gs^Fms, Gs^Fms, Gs^Fms, Gs^Fms, Gs^Fms
Gg, Hh, Gs, Gs^Edt, Gs^Edt, Gg^Edt, Gg, Hh, Mm, Mm, Hh, Hh, Re, Ww, Sm, Ww, Sm, Ww, Ss, Ww, Ww, Gg^Edt, Gg, Chr^Edt, Chr^Edt, Chr, Gg, Gs^Edt, Gs^Fms, Gs^Fms, Gs^Fms, Gs^Fms, Gs^Vh, Gs^Fms, Ww, Ww
Ss, Ss, Hh, Hh, Gs^Em, Gs^Edt, Gg^Efm, Hh, Mm, Mm, Hh, Re, Hh, Hh, Hh, Hh, Hh, Hh, Gg, Ss, Ss, Ww, Ww, Gs^Fms, Gs^Fms, Gs^Fms, Ww, Gs, Gs^Fms, Gs^Fms, Ww^Es, Gs^Fms, Ww, Ww, Ww, Ww
Ss, Ss, Ss, Gg, Hh, Gs, Gs^Edt, Gg, Hh, Hh, Gg, Re, Hh, Hh, Hh, Mm, Mm, Mm, Ss, Gg, Gs^Vh, Ww, Ww, Ww^Es, Ww, Ww^Bw|, Ww, Ww, Ww, Ww, Ww, Ww^Es, Ww, Ww, Gg, Gg
Ss, Ss, Ss, Ss, Hh, Hh, Gs, Gs, Ss, Ss, Re, Re, Ss, Hh, Mm, Mm, Mm, Mm, Hh, Ss, Ss, Ss, Ww, Ww, Ww, Gs^Bw|, Ww, Ww, Ww, Ww, Mm, Ww, Hh, Gs^Fms, Gg^Ve, Ss
Ss, Ss, Ss, Ss, Hh, Hh, Gg, Ss, Ss, Chr^Ecf, Ss, Ss, Ss, Hh, Mm, Mm, Mm, Mm, Hh, Ss, Ss, Gs^Fp, Ww, Ww, Gs^Ft, Ww^Bw|, Hh, Mm, Mm, Hh, Mm, Hh, Hh, Ss, Ss, Ss
Gs^Fp, Ss^Vhs, Ss, Hh, Chr, Gs, Gg^Edt, Gg, Chr^Ecf, Chr^Ecf, Ss, Ss, Ss, Ss^Vhs, Hh, Mm, Mm, Hh, Hh, Ss, Ss, Ww^Em, Ww, Gs^Ft, Ss, Gs^Ft, Gs^Emf, Gs^Emf, Mm, Mm, Mm, Mm, Mm, Hh, Hh, Ss
Ss, Ss, Ss, Chr, Khr, Chr, Gs, Gg, Re, Ss, Ss, Ss, Ss, Ss, Ss, Hh, Hh, Gs, Gs, Gs^Fp, Gs^Emf, Ww, Ww, Gs^Ft, Gg, Gs^Emf, Ss, Ss, Ss, Mm, Hh, Hh, Mm, Mm, Hh, Gg
Ss, Ss, Hh, Chr, Chr^Edt, Chr^Edt, Gs, Gg^Ve, Gs, Ss, Gs^Fms, Ss, Gg^Efm, Gs^Fp, Gs^Fp, Ss, Ss, Gs, Gg^Edt, Gs^Fp, Ww, Ww, Gs^Emf, Gs^Emf, Gs^Emf, Gs^Emf, Gg, Gg^Edt, Gg, Ss, Ss, Hh, Hh, Hh, Gg, Gg
Ss, Ss, Hh, Mm, Gs^Fms, Gs, Gg, Gg, Gg, Gs^Edt, Gs^Edt, Gg^Edt, Gg, Gg, Gs^Vh, Gs^Fp, Gs^Fp, Gs, Gs, Gs, Ww, Ww, Gs^Emf, Gg, Ss, Ss, Ss, Ss, Ss, Ss, Ss, Ss, Ss, Ss, Ss, Ss
Gs^Fms, Gs^Fms, Gs^Fms, Gs^Fms, Gs, Gs, Mm, Hh, Mm, Gs, Mm, Gs^Edt, Gs, Gs, Gs, Ss, Ss, Ss, Ww, Ww, Ww^Em, Ww, Ss, Ss, Gs^Fms, Gs^Fms, Gs^Fms, Gg^Ve, Ss, Ss, Ss, Ss, Chs, Ss, Ss, Ss
Gs^Fms, Gs^Fms, Gs^Fms, Gs^Fms, Gs, Hh, Hh, Mm, Mm, Mm, Mm, Hh, Mm, Gs^Edt, Gs, Ss, Gs^Fms, Ww, Ww, Ww, Ss, Ss, Gg^Ve, Ss, Gs^Fms, Gs^Fms, Gs^Fms, Gs^Fms, Gs^Fms, Ss, Chs, Ss, Ss, Chs, Gs, Ss
Ss, Gs^Fms, Gs^Fms, Gs^Fms, Gs, Gg, Gs^Fms, Hh, Hh, Hh, Hh, Mm, Gs, Mm, Gs, Gs^Fms, Ww^Es, Ww, Ww, Gs^Fms, Ss, Ss, Ss, Ss, Gs^Fms, Gs^Fms, Gs^Fms, Gs^Fms, Ss, Chs, 3 Khs, Chs, Ss, Chs, Gs, Ss
Gg, Gg^Efm, Gs^Fms, Gs^Fms, Gs, Gs^Edt, Gs, Gs^Vh, Ss, Hh, Gg, Ch, Ss, Gs, Gs^Fms, Gs^Fms, Ww^Es, Ww^Es, Ww, Gs^Fms, Ss, Ss, Gs^Fms, Gs^Fms, Ss, Gs^Fms, Ss, Gs^Fms, Ss, Chs, Chs, Chs, Ss^Vhs, Ss, Ss, Gs
Ds, Gg, Gg, Gs^Fms, Sm, Sm, Sm, Ss, Ss, Ss, Ss^Vhs, Ww^Bw|, Ss, Ss, Gs^Fms, Gs^Fms, Ww, Ww, Ww, Sm, Gs^Fms, Gs^Fms, Gs^Fms, Gs^Fms, Ss, Ss, Ww^Vm, Ss, Ss, Ss, Ss, Ss, Ss, Ss, Ss, Ss
Ww, Ds, Ww, Ww, Ww, Ss, Ww^Bw|, Ss, Ww, Ss, Gg, Re, Gs^Fp, Gs^Fp, Ww, Ww, Gs^Fms, Sm, Sm, Ww, Ww, Ww, Ww, Gs^Fms, Ww, Ss, Gg, Ss, Gg, Ss, Ss, Ss, Gg, Gs^Edt, Gg, Ss
Ww, Ww, Ds, Gg, Ss, Ww, Gg, Ww, Gs^Ft, Ww, Ww, Ww, Ww, Ww, Gs^Ft, Gs^Ft, Ss, Sm, Ss, Sm, Sm, Gs^Fms, Gs^Fms, Ww, Ww, Ww, Gg, Gg, Ss, Gg, Gg^Edt, Gg^Edt, Ss, Gg, Ss, Ss
Ww, Ww, Ds, Gg^Edt, Ss, Ss, Gs^Ft, Gs^Ft, Ss, Gs^Ft, Gs^Ft, Gg, Gs^Ft, Gs^Ft, Gs^Ft, Gs^Ft, Ss, Ss, Ss, Sm, Sm, Gs^Fms, Gs^Fms, Gs^Fms, Gs^Fms, Ww, Ww^Em, Ss, Gs^Ft, Gg, Ss, Ss, Ss, Ss, Gg, Gg
Wo, Ww, Ww, Ds, Gg, Gg, Ss^Emf, Ss^Emf, Ss^Emf, Ss^Emf, Ss^Emf, Gs^Ft, Gs^Ft, Gs^Fp, Gs^Ft, Gs^Ft, Ss^Vhs, Ss, Ss, Sm, Ss, Gs^Fms, Ss^Emf, Gs^Fms, Ss, Ww, Ww, Gs^Ft, Gs^Ft, Ss, Ss, Ss, Ss^Vhs, Gs^Fp, Gg, Gg
Wo, Ww, Ww, Ds, Gg, Ss^Emf, Ss^Emf, Ss^Emf, Ss, Ss, Ss, Ss^Emf, Gs^Fp, Gs^Fp, Gs^Fp, Gs^Fp, Gg, Ss, Gs^Fp, Ss, Ss, Ss^Emf, Ss^Emf, Ss^Emf, Ss, Ww, Ww^Bw/, Gs^Ft, Gs^Ft, Gg, Gg^Efm, Ss, Ss, Ss, Gs, Gg
Wo, Wo, Ww, Ds, Ds, Gg, Ss^Emf, Ss^Emf, Ss^Emf, Ss, Ss, Ss^Emf, Ss, Gs^Fp, Gs^Fp, Gs^Fp, Gs^Fp, Gs^Fp, Gs^Fp, Gs^Fp, Ss, Ss^Emf, Ss^Emf, Ss^Emf, Ss^Emf, Ww^Bw/, Ww, Ss, Gs, Gg, Gs, Gg, Gs, Gs, Gs, Gg
Wo, Ww, Ww, Ds, Ds, Gg, Gs^Em, Ss^Emf, Ss, Ss^Vhs, Gs, Ss, Ss, Ss, Ss, Gs^Fp, Gs, Gs^Fp, Gs^Fp, Ss, Ss, Ss^Emf, Ss, Ss^Emf, Ss, Ww, Ww^Es, Ss, Gs, Gs, Gs^Fms, Gs, Gs^Edt, Gs^Fms, Gs^Fms, Ss
Wo, Ww, Ww, Ww, Ds, Gg, Gs, Gs^Em, Sm, Ss, Gs, Ss, Ss, Gs^Ft, Gs^Ft, Gs^Ft, Gs, Gs^Edt, Gs^Fp, Ss, Gg, Gs^Em, Gg, Ss, Ss, Ww, Ww, Gs^Fms, Gs^Fms, Gs^Fms, Gs^Fms, Gs^Fms, Gs^Fms, Gs^Fms, Gs^Fms, Gs^Fms
Wo, Wo, Ww, Ww, Ds, Gg^Edt, Gg, Gs^Em, Gs, Gs, Gg, Gs^Ft, Gs^Ft, Ss, Sm, Gs^Ft, Gs^Edt, Gs, Gg, Gg, Ds, Gg, Ds, Ss, Gg^Efm, Gg, Ww, Gs^Fms, Ss, Gs^Fms, Gs^Fms, Gs^Fms, Gs^Fms, Gs^Fms, Gs^Fms, Gs^Fms
Wo, Wo, Ww, Ds, Ds, Gg, Ss, Sm, Ss, Gs, Ss, Ss, Ss, Ss, Sm, Ss, Ss, Ds, Ds, Ds, Ds, Ds, Ds, Ds, Gg, Gg, Ww, Ss, Gs, Ss, Ss, Gs^Fms, Gs^Fms, Gs^Fms, Gs^Fms, Gs^Fms
Wo, Wo, Ww, Ww, Ww, Ds, Ds, Sm, Gs^Ft, Ss, Ce, Ce, Ce, Ss, Gs^Ft, Sm, Ds, Ds, Ww, Ww, Ww, Ww, Ww, Ds, Ds, Ww, Ds, Gg, Gs, Gs, Gg^Edt, Gs^Fms, Gs^Fms, Gs^Fms, Gs^Fms, Gs^Fms
Wo, Wo, Wo, Ww, Ww, Ww, Ds, Gs^Ft, Gs^Ft, Gs^Ft, Ce, 1 Ket, Ce, Sm, Sm, Sm, Ds, Ww, Ww, Ww, Ww, Ww, Ww, Ww, Ww, Ww, Ww, Ds, Ds, Gg, Gs, Gg, Ss, Gs^Fms, Gs^Fms, Gs^Fms
Wo, Wo, Wo, Wo, Ww, Ww, Ds, Ss, Gs^Ft, Gs^Ft, Ss, Ce, Ss, Sm, Ds, Ds, Ww, Ww, Wo, Ww, Ww, Ww, Ww, Ww, Ww, Ww, Ww, Ww, Ww, Ds, Ds, Gg, Gg, Ss, Gg, Gs^Fms
Wo, Wo, Wo, Wo, Wo, Ww, Ww, Ds, Ds, Ss, Ds, Ds, Ds, Ds, Ww, Ww, Ww, Ww, Wo, Wo, Wo, Ww, Ww, Wo, Wo, Ww, Ww, Ww, Ww, Ww, Ww, Ds, Ds, Ds, Ds, Gg
Wo, Wo, Wo, Wo, Wo, Ww, Ww, Ww, Ww, Ww, Ww, Ww, Ww, Ww, Ww, Ww, Wo, Wo, Wo, Wo, Wo, Wo, Wo, Wo, Wo, Wo, Wo, Ww, Ww, Ww, Ww, Ww, Ww, Ww, Ww, Ds
Wo, Wo, Wo, Wo, Wo, Wo, Wo, Ww, Ww, Ww, Wo, Ww, Wo, Wo, Wo, Wo, Wo, Wo, Wo, Wo, Wo, Wo, Wo, Wo, Wo, Wo, Wo, Wo, Wo, Wo, Wo, Ww, Wo, Ww, Ww, Ww
Wo, Wo, Wo, Wo, Wo, Wo, Wo, Wo, Wo, Wo, Wo, Wo, Wo, Wo, Wo, Wo, Wo, Wo, Wo, Wo, Wo, Wo, Wo, Wo, Wo, Wo, Wo, Wo, Wo, Wo, Wo, Wo, Wo, Wo, Wo, Wo
