Wo, Wo, Wo, Wo, Wo, Wo, Wo, Wo, Wo, Wo, Wo, Wo, Wo, Wo, Ww, Wo, Ww, Ww, Ww, Ww, Ww, Ww, Wo, Wo, Wo, Wo, Wo, Wo, Wo, Wo, Wo, Wo, Wo, Wo, Wo
Wo, Wo, Wo, Wo, Wo, Wo, Wo, Wo, Ww, Ww, Ww, Ww, Ww, Ww, Ds, Ww, Ds, Ww, Gg, Ds, Ww, Ww, Ww, Ww, Ww, Wo, Wo, Wo, Wo, Wo, Wo, Wo, Wo, Wo, Wo
Wo, Wo, Wo, Wo, Wo, Wo, Ww, Ww, Ds, Ww, Ds, Ww, Ds, Ds, Ds, Ds, Ww, Ss, Gg, Ds, Ds^Bw/r, Ww, Ww, Ww, Ww, Wo, Wo, Wo, Wo, Wo, Wo, Wo, Wo, Wo, Wo
Wo, Wo, Ww, Wo, Ww, Ww, Ds, Ds, Gs^Fmw, Gs^Fmw, Gs^Fmw, Gg, Gg^Efm, Ss, Ss, Ss, Ss, Ww, Ww, Gg^Efm, Ww, Ds, Ds, Ww, Ww, Ww, Ww, Wo, Wo, Wo, Wo, Wo, Wo, Wo, Wo
Ww, Ww, Ds, Ww, Ds, Ds, Gg^Fet, Gg^Fet, Gs^Fmw, Gs^Fmw, Gs^Fmw, Gs^Fmw, Gs^Fmw, Gs^Fmw, Ss, Ss, Gs^Fmf, Ss, Ss, Gg, Ww, Gs, Gs^Edt, Ds, Ww, Ww, Ww, Wo, Wo, Wo, Wo, Wo, Wo, Wo, Wo
Ds, Ds, Gs^Fmw, Ds, Gs^Fmw, Gs^Fmw, Gs^Fmw, Gs^Fmw, Cvr, Gs^Fmw, Gs^Fmf, Gs^Fmf, Gs^Fmw, Gs^Fmw, Ss, Gs^Fmf, Gs, Ss, Ss, Gll^Fmf, Ww, Gg, Gs, Ds, Ds, Ds, Ds^Bw/, Ww, Ww, Wo, Wo, Wo, Wo, Wo, Wo
Gs^Fmw, Gs^Fmw, Gs, Gs^Fmw, Gs^Fmw, Gs^Fmw, Gs^Fds, Cvr, 3 Kvr, Cvr, Gs^Fms, Gs^Fmf, Gs^Fmf, Ss, Gs^Edt, Gs, Gs^Es, Gs^Fms, Gg, Gg, Gll^Fmf, Ww, Gll^Fmf, Gg, Gg, Gg, Ds, Ww, Ww, Ww, Ww, Wo, Wo, Wo, Wo
Gs^Fmw, Gs^Fds, Gs, Gs^Efm, Gs^Fds, Gg^Ve, Gs^Fds, Cvr, Cvr, Cvr, Gs^Fds, Gg^Ve, Gg, Gs, Gs, Gs, Gs, Gs^Fms, Gg, Gg, Gg, Ww, Ww, Gll^Fmf, Gll^Fmf, Gg, Gg, Ds, Ds, Ww, Ww, Ww, Ww, Wo, Wo
Gs^Fds, Gs^Fds, Gs^Fds, Gs^Em, Gs^Em, Gs^Fds, Gs^Fds, Gs^Fds, Gg^Em, Gs^Fds, Gg, Gg^Efm, Gg, Gs, Gg, Gs^Fms, Ww, Gs^Fms, Gs^Fms, Gs^Vh, Gg, Gg, Ww, Gll^Fmf, Gg, Gg, Gs, Gg, Gg, Ds, Ds^Bw/r, Ww, Ww, Wo, Wo
Ww, Gs^Fds, Ww, Gs^Fds, Gs^Fds, Gs^Fds, Gg, Gg, Gg, Gs, Gg, Gg, Ww, Gg, Gg, Gs^Fms, Ww, Gs^Fms, Gs^Fms, Gs^Fms, Wo, Ww, Gg, Gll^Fmf, Gg, Ss, Ss, Ss, Gg, Gg, Gg, Ds, Ww, Wo, Wo
Gs^Fds, Gs^Fds, Gs^Fds, Ww, Wo, Gg, Gg, Gg, Hh, Hh^Em, Ww, Ww^Em, Hh^Em, Wo, Gs^Fms, Gs^Fms, Gg, Ww, Gs^Fms, Gs^Fms, Gg, Gg, Gg, Gll^Fmf, Gg, Gg, Gg, Ss, Gg, Gs^Em, Gg, Ds, Ww, Ww, Ww
Gg, Gg, Hh, Hh, Hh, Wo, Hh, Ww, Ww, Ww, Hh^Em, Hh^Em, Md, Hh, Hh, Gs^Fms, Gs^Fms, Gs^Fms, Gg, Gg, Gg, Gs, Gg, Gg, Gg, Gs^Ecf, Gs^Edt, Gg, Gs^Fmw, Gs, Gs, Ds, Ds, Ww, Ww
Gg, Gg^Es, Hh, Hhd^Vhhr, Md, Hh, Md, Hh, Hh, Hh, Md, Md, Md, Md, Md, Hh, Gg, Gg, Gs^Ftp, Gg, Gs^Ftp, Gg, Gg, Ss, Ss, Gg, Chr, Chr, Chr, Gs^Fmw, Gs^Fmw, Gs, Ww, Ww, Ww
Hh, Hh^Em, Hh, Md, Md, Md, Md, Md, Md, Md, Md, Md, Hh^Em, Md, Hh, Md, Md, Gg, Gs^Ftp, Gs^Ftp, Gg^Tf, Gg^Tf, Gs^Vh, Ss, Ss, Gg, Chr^Edt, 2 Khr, Chr, Gs^Fmw, Gs, Gg, Ss, Ww, Ww
Md, Md, Md, Hh, Hh, Md, Md, Md, Md, Md, Hh, Hh, Gg, Hh, Gg, Gs, Gg, Gs^Ftp, Gs^Ftp, Gs^Ftp, Gg, Gg, Gg, Ss, Ss, Gg, Gg^Edt, Chr, Gg, Gs, Gs^Vc, Gg, Ss, Ww, Ds
Md, Md, Md, Md, Md, Md, Md, Md, Md, Hh, Hh, Gg, Gs^Es, Gg, Gg, Gg, Ss, Gg, Gs^Ftp, Gs^Ftp, Ss^Bw\, Ss, Ss, Ss, Ss, Gg^Edt, Gg, Gg, Gs^Edt, Gs, Gg, Gg, Ww, Ww, Gg
Md, Md, Md, Md, Md, Md, Md, Md, Md, Hh, Gg, Gg, Gs, Gs, Ss, Ss^Vhs, Ss, Gg, Ss, Ss, Ss, Ss^Bw\, Ss^Bw\, Ss, Ss, Gg, Ww, Ww^Es, Ww, Gg, Ww, Ww, Ww, Ss^Emf, Ss
Md, Md, Md, Md, Md, Md, Md, Md, Hh^Vhh, Hh, Gg, Gg, Gs, Gs, Gs^Fds, Ss, Ss, Ss^Bw\, Ss^Bw\, Ss, Ss, Ss, Ww, Ww, Gs, Ww, Gg, Gs^Ftp, Gs^Ftp, Gg, Gg, Gg, Ss, Ss, Gg
Md, Md, Md, Md, Md, Md, Hh^Em, Hh^Em, Hh^Em, Hh, Gg, Gs, Gs^Fds, Gg, Gs^Fds, Gs^Fds, Ss, Ss, Ss, Ss^Bw\, Gg, Gg, Wo, Gg, Gg, Gg, Gg, Gs^Ftp, Gs^Ftp, Gs^Edt, Gs^Ftp, Gg, Gg, Gg, Gg
Md, Md, Hh, Hh^Em, Hh, Hh^Em, Hh, Hh, Gg, Gg, Gg, Gs^Fds, Gs^Fds, Gs^Fds, Gs^Fds, Ss^Bw\, Ss^Bw\, Ss, Ss, Ss, Gs^Fms, Gg, Ww, Gg, Gg, Gs^Vh, Gg, Gg, Gs^Ftp, Gs^Ftp, Gg, Gg, Ss, Gg, Gg
Hh, Hh, Gg, Hh, Gg, Gg, Gg, Gg, Gg, Gs^Edt, Gg, Gs^Fds, Gg, Gs^Fds, Ss, Ss, Ss, Ss^Bw\, Gs^Fms, Gs^Fms, Gs^Fmw, Gs^Fms, Ww, Gg, Ss, Gg, Ss, Gg, Gs^Ftp, Gs^Ftp, Gg, Gg, Ss, Gg, Ss
Gg, Gg, Gg, Gg, Gs^Fms, Gg, Gs^Fdw, Gg, Gg, Gs^Fdw, Gll^Fdw, Gg, Gg, Ss, Ss^Tf, Ss^Tf, Ss, Gs^Vl, Gs^Fms, Gs^Fms, Gg, Gs^Fmw, Ww^Es, Gg, Ss, Ss, Gg, Gg, Gs, Gs^Ftp, Gg, Gg, Ss, Ss, Ss
Gs^Fms, Gs^Fms, Gs^Fms, Gs^Fms, Gg, Gg, Gg, Gs^Fdw, Gs^Fdw, Gs^Fdw, Gs^Fdw, Gll^Fdw, Gg, Gg, Ss, Ss^Tf, Ss^Tf, Gs^Fms, Gs, Gs^Fmw, Gg, Gg, Gg, Ww, Ss, Gg, Gg, Gs^Em, Gs^Es, Gg, Ss, Ss, Ss, Ss^Vhs, Ss
Gs^Fms, Gs^Fms, Gs^Fms, Gg, Gg, Gg, Gg, Gs^Fdw, Gg, Gs^Vh, Gg, Gg, Gg, Gg, Ss^Bw\, Ss^Tf, Gs, Gs, Gs, Gg, Gg, Ss, Ss, Gg, Ww, Gg, Gs, Gs^Em, Gs, Gs^Es, Ss, Ss, Ss^Emf, Ss, Ss
Gs^Fms, Gs^Fms, Gg, Gg, Gs, Gs, Gs, Gg, Gg, Gg, Gg, Gg, Ss, Ss, Ss, Ss^Bw\, Gs^Ftp, Gs, Gs^Fmf, Gs^Fmf, Ss, Gs^Edt, Ss, Ss, Ss, Ww, Ww, Gg, Gs, Gs, Ss^Emf, Ss^Emf, Ss^Emf, Ss, Ss^Emf
Gs^Fms, Ss^Tf, Ss^Tf, Gg, Ss, Gs, Gs, Gg, Ss, Gg, Ss, Gg, Ss, Ss, Ss, Ss, Gs, Gs, Gg, Gg, Ss, Ss, Ss, Ss, Ss, Gg, Gg, Ww, Ww, Ss, Ss, Ss^Emf, Ss^Emf, Ss^Emf, Ss^Emf
Gll^Fp, Ss^Tf, Ss^Tf, Ss, Ss, Gg, Gg, Ss, Gg, Ss, Ss^Emf, Ss, Ss^Emf, Ss^Emf, Ss^Emf, Ss, Ss, Gs^Ftp, Gg, Gs^Es, Ss, Ss, Gs^Em, Ss, Ss, Ss^Vhs, Ss, Ss, Ww, Ww, Ss, Ss^Emf, Ss, Ss^Emf, Ss^Emf
Gll^Fp, Gll^Fp, Ss, Ss, Ss, Gg, Chr, Gg, Ss, Ss, Ss, Ss^Emf, Ss, Ss^Emf, Ss, Ss, Ss, Gg, Ss, Ss, Gll^Ftr, Ss, Ss, Ss, Sm, Ss, Ss, Ss, Wo, Ww, Gg, Ss, Gg, Ss, Ss
Ss, Ss, Ss^Vhs, Ss, Ss, Chr, 1 Khr, Chr, Ss, Gg, Gs^Fdw, Gll^Fdw, Gg, Gg, Gg, Gg, Ss, Ss, Gll^Ftr, Gll^Ftr, Gll^Ftr, Ss, Gll^Ftr, Sm, Sm, Sm, Ss, Ss, Gg, Ww, Gg, Gg, Gs, Gg, Gg
Gg, Ss, Ss, Ss, Gs, Chr, Chr, Chr, Gg, Gs^Fdw, Gll^Fdw, Gll^Fdw, Gll^Fdw, Gs^Fdw, Gs^Fdw, Gg, Gg, Ss, Ss, Ss, Gll^Ftr, Ss, Gll^Ftr, Sm, Sm, Sm, Ss, Gg, Gg, Ww, Gg, Ss, Ss, Ss, Ss
Gg, Gg, Gg, Gg, Ss, Gs, Gs, Gg, Gs^Fdw, Gll^Fdw, Gs^Fdw, Gs^Fdw, Gg, Gs^Fdw, Gg, Gg, Ss, Gg, Ss, Ss, Ss, Gll^Ftr, Ss, Ss, Ss, Sm, Sm, Gg, Gs, Ww, Ww, Ss, Ss, Ss, Ss
Gs, Gs, Gg, Gg, Ss, Ss, Ss, Gg, Gg, Gg, Gs^Fdw, Gg, Gs^Es, Gg, Gg, Gg, Ss, Ss, Ss^Vhs, Ss, Ss, Sm, Sm, Ss, Ss, Gg^Es, Sm, Gg, Gg, Ww, Gg, Ss, Ss^Vhs, Ss, Ss
Gg, Gs, Gs, Gg, Gg, Ss, Ss, Gg, Gg, Gg, Gs^Fds, Gg, Gg, Gg, Gll^Fp, Ss, Ss, Ss, Ss, Ss, Sm, Sm, Sm, Sm, Ss, Ss, Ss, Gs, Gg, Ww, Ss, Ss, Ss, Ss, Ss
Gg, Gg, Ss^Tf, Ss^Tf, Ss, Ss, Ss, Gs^Fds, Gg^Ve, Gs^Fds, Gg, Gg, Gg, Gg, Ss, Ss, Ss, Ss, Sm, Sm, Ss, Sm, Sm, Gs, Gs^Edt, Gs, Ss, Gs^Edt, Ww, Ww, Ss, Gs^Edt, Gs, Gs, Ss
Gg, Gs, Gs, Ss, Ss^Emf, Ss^Emf, Ss^Emf, Ss, Gll^Fp, Gll^Fp, Gll^Fp, Gll^Fp, Ss, Ss, Ss, Ss, Ss, Sm, Ss, Ss, Ss, Ss, Ss, Ss, Gs, Gg^Edt, Ss, Ss, Ww, Ww, Ss, Ss, Ss, Ss, Ss
Gg, Gg, Gg, Ss, Ss, Ss^Emf, Gg^Emf, Gll^Fp, Gll^Fp, Gll^Fp, Gll^Fp, Gg, Ss, Ss, Ss, Ss, Gg, Ss, Gg, Ss, Ss, Ss, Ss, Ss, Ss, Ss, Ss, Ww, Ss, Ss, Ss, Ss, Ss, Ss, Ss
