Wo, Wo, Wo, Ww, Ww, Wo, Wo, Wo, Ww, Ww, Ww, Ww, Ww, Wo, Wo, Wo, Wo, Wo, Ww, Ww, Ww, Ww, Ww, Md, Hh^Fdw, Hh^Fdw, Hh^Fdw, Hh^Fdw, Hh^Fdw, Hh^Fdw, Ds, Ww, Ww, Wo, Wo, Wo, Wo, Wo, Wo, Wo, Wo, Wo
Wo, Wo, Wo, Ww, Ds, Ww, Ww, Wo, Ww, Ww, Ds, Ds, Ds, Ww, Ww, Wo, Ww, Ww, Ds, Ds, Ds, Ww, Ww, Hh^Fdw, Hh^Edt, Hh^Fdw, Hh^Fdw, Gg^Fet, Hh^Fet, Gg^Fet, Ds, Ww, Ww, Wo, Ww, Wo, Wo, Wo, Wo, Wo, Wo, Wo
Wo, Wo, Ww, Ww, Ds, Ds, Ds, Ww, Hh^Fdw, Hh^Fdw, Hh^Fdw, Ds, Hh^Fdw, Ds, Ds, Ww, Ds, Ww, Ds, Hh, Ww, Ww, Hh, Hh^Fdw, Hh^Fet, Hh^Fdw, Gs^Fdw, Gg^Fet, Gs^Fdw, Gs^Fdw, Gll^Fdf, Ds, Ds, Ww, Ww, Wo, Wo, Wo, Wo, Wo, Wo, Wo
Wo, Wo, Ww, Gg, Gg, Gs^Es, Gg, Ww, Ww, Hh^Fdw, Wo, Gs, Hh^Em, Gs, Hh^Em, Ww, Hh^Em, Ds, Hh^Em, Hh, Ww, Ww, Hh^Fdw, Hh^Fdw, Hh^Fdw, Gs^Fdw, Gg^Fet, Gs^Fdw, Gs^Fdw, Gll^Fdf, Gs^Fdw, Ds, Ww, Ww, Wo, Wo, Wo, Wo, Wo, Wo, Wo, Wo
Wo, Ww, Gg^Efm, Gs^Efm, Gs^Efm, Gg, Gg^Fet, Gg, Gs^Fmw, Ww, Gg, Wo, Ww, Gg, Ww, Hh^Em, Gg, Hh^Em, Gg, Ww, Ww, Wo, Ds, Hh^Fdw, Gs, Hh, Hh, Gs^Fdw, Gg^Fet, Gg^Efm, Hh^Fdw, Hh^Fdw, Ww, Ww, Ww, Wo, Ww, Wo, Wo, Wo, Wo, Wo
Ww, Ww, Gg^Efm, Gg^Efm, Hh^Fdw, Gg, Gs, Gg, Gg, Gg, Gg, Gg, Gg, Ww, Ww, Ds, Gs, Gll^Fmf, Ww, Ww, Gg^Efm, Wo, Wo, Ds, Gs^Edt, Hh^Es, Hh, Hh, Hh, Gs^Edt, Gs^Edt, Hh^Fdw, Hh^Fdw, Ww, Ww, Ww, Ww, Ww, Ww, Wo, Wo, Wo
Gg^Efm, Gg^Efm, Gs^Efm, Ds, Hh^Fdw, Hh^Fdw, Hh^Fmw, Hh^Fmw, Hh^Fmw, Gs^Fmw, Gd^Efm, Gd^Efm, Gs^Fmw, Gg, Gg, Ww, Ww, Ww, Ww, Gll^Fmf, Gd, Gd, Gll^Fmf, Ww, Ww, Gs, Hh, Hh, Hh^Em, Gg, Md, Gs, Hh, Ds, Ds, Ww, Ww, Ww, Wo, Wo, Wo, Wo
Gs^Efm, Gg^Efm, Gs^Efm, Gs^Efm, Hh^Fdw, Hh^Fmw, Gs^Fmw, Hh^Fmw, Gs^Fdw, Hh^Fmw, Hh^Fmw, Gs^Fmw, Gs^Fmw, Gg, Gg^Em, Hh^Em, Hh^Em, Hh^Fmw, Hh^Fmw, Ww, Gd, Gll^Fmf, Gll^Fdf, Wo, Md, Ww, Ww, Hh, Hh, Hh, Md, Md, Hh, Hh^Fdf, Hh^Fdf, Ds, Ww, Ww, Wo, Wo, Wo, Wo
Gs^Efm, Gs^Efm, Gs^Efm, Gs^Efm, Gs^Fdw, Gg^Fet, Gg^Fet, Gs^Fmw, Ce, Ce, Ce, Gs^Fmw, Gg^Em, Hh, Hh, Hh^Em, Ww, Hh^Fmw, Hh^Fmw, Ww, Gg^Es, Gll^Fmf, Gd, Gll^Fmf, Gll^Fmf, Wo, Wo, Ww, Hh, Hh, Hh, Hh, Hh, Hh, Hh^Fdf, Hh^Fdf, Ds, Ww, Wo, Wo, Wo, Wo
Gs^Efm, Gs^Efm, Gs^Efm, Gs^Fdw, Gs^Fdw, Gs^Fdw, Gs^Fdw, Gs^Fmw, Ce, 1 Ket, Ce, Gs^Fmw, Gg^Em, Hh^Em, Gs^Em, Hh^Em, Ww, Ww, Ww, Ww, Ww, Ww, Ww, Gll^Fmf, Ww, Gll^Fmf, Wo, Wo, Wo, Ww, Ww, Wo, Wo, Wo, Ww, Ds, Ww, Ww, Ww, Wo, Wo, Wo
Gs^Fdw, Gs^Fdw, Gs^Fdw, Gs^Fdw, Wo, Gs^Fdw, Ds, Gs^Efm, Gs^Efm, Ce, Gs^Efm, Gg^Em, Ds, Gg^Vh, Gs^Em, Hh^Fdw, Ww, Ww, Wo, Ww, Wo, Wo, Wo, Ww, Wo, Wo, Wo, Wo, Ww, Ww, Hh^Em, Hh^Fdf, Hh^Fdf, Hh^Fdf, Hh^Em, Ww, Gs^Efm, Ww, Ww, Ww, Wo, Wo
Gs^Fdw, Gs^Fdw, Gs^Fdw, Gs^Fdw, Wo, Wo, Ds, Gs^Efm, Gs^Efm, Gs^Efm, Ds, Ds, Gs^Em, Gs^Em, Gs^Em, Ww, Ww, Wo, Wo, Ww, Ww, Wo, Ww, Wo, Ww, Ww, Ww, Ww, Ww, Ww, Hh, Hh, Hh^Em, Hh^Fdf, Hh, Hh^Em, Hh, Ds, Ww, Ww, Wo, Wo
Wo, Ww, Wo, Wo, Ww, Ww, Wo, Ds, Gg^Vh, Gs^Efm, Ds, Gs^Em, Gs^Em, Gs^Em, Hh^Fdw, Ww, Wo, Wo, Wo, Wo, Ww, Ww, Ww, Ww, Ww, Ww, Wo, Ww, Wo, Ww, Hh, Hh^Fmw, Hh, Hh, Hh^Vh, Hh, Hh, Ds, Ww, Ww, Wo, Wo
Wo, Wo, Wo, Ww, Ww, Wo, Wo, Ds, Ds, Ds, Hh^Fdw, Gs^Em, Hh^Fdw, Hh^Fdw, Hh^Fdw, Hh^Fdw, Wo, Ww^Vm, Ww, Ww, Ww, Ww, Ds, Ds, Hh^Fdw, Gg^Efm, Gg^Efm, Wo, Wo, Ww, Wo, Wo, Hh^Em, Hh^Em, Hh, Hh, Ds, Ds, Ww, Ww, Ww, Ww
Ww, Ww, Gs^Fdw, Ww, Ww, Wo, Wo, Ds, Wo, Hh^Fdw, Hh^Fdw, Hh^Fdw, Wo, Wo, Wo, Wo, Wo, Wo, Wo, Ww, Wo, Wo, Ds, Hh^Fdw, Hh^Fdw, Hh^Fdw, Gg^Efm, Gs^Fdw, Gs^Fdw, Wo, Gs^Fdw, Gg^Efm, Hh^Em, Md^Xm, Hh, Hh, Hh^Fmf, Ds, Ds, Ww, Ww, Ww
Gg^Gvs, Gg^Gvs, Gg^Gvs, Gs^Fmw, Gg^Gvs, Ww, Ww, Wo, Ww, Wo, Wo, Wo, Wo, Ww, Wo, Wo, Ww, Wo, Wo, Wo, Wo, Wo, Ds, Ds, Gs^Fmw, Hh^Em, Gs^Vh, Gg^Gvs, Gs^Fdw, Wo, Wo, Gg^Efm, Gs^Efm, Hh, Gs^Fdw, Gs^Fdw, Gg^Fdw, Hh^Fmf, Md^Xm, Ds, Ds, Ds
Gs^Fmw, Gs^Fmw, Gs^Fmw, Gg^Gvs, Gs^Fmw, Gs^Em, Gs^Em, Ww, Ww, Ww, Ww, Wo, Ww, Ww, Ww, Wo, Wo, Ww, Ww, Wo, Ww, Ds, Hh, Hh^Em, Hh^Em, Hh^Em, Hh^Em, Gg^Gvs, Gg^Gvs, Ds, Ds, Gg^Efm, Gs^Efm, Gs^Fdw, Md, Md, Hh^Fmf, Md^Xm, Md^Xm, Md^Xm, Md^Xm, Md^Xm
Gs^Fmw, Gs^Fmw, Gs^Fmw, Gs^Fmw, Gd, Gs^Em, Gs^Fmw, Gs^Efm, Gs^Fmw, Ww, Ww, Ww, Ww, Ww, Ww, Ww, Ww, Wo, Wo, Ww, Ww, Ds, Hh, Hh^Fdw, Hh^Em, Hh^Em, Md, Md, Gg^Gvs, Gg^Gvs, Ds, Gg^Efm, Gg^Efm, Gg^Efm, Md, Md, Hh^Fmf, Hh^Fmf, Md^Xm, Md, Md, Md
Gs^Efm, Gs^Efm, Gs^Efm, Gs^Efm, Gs^Fmw, Gs^Fmw, Gs^Em, Gs^Fmw, Gg^Gvs, Gs^Fmw, Gg^Gvs, Ww, Ww, Wo, Ww, Ww, Ww, Ww, Wo, Wo, Ds, Ds, Gs^Fmw, Hh, Hh, Hh^Em, Cte, Md, Gs^Fdw, Hh^Fdw, Hh^Ve, Hh^Fdw, Hh, Hh^Fdw, Hh^Fmf, Hh^Fmf, Ds, Hh^Fmf, Hh^Fmf, Hh^Fmf, Hh^Fmf, Md
Gs^Efm, Gs^Efm, Gs^Efm, Gs^Fmw, Gs^Fmw, Gs^Fmw, Gs^Fmw, Gs^Em, Gs^Em, Gg^Gvs, Gg^Gvs, Gg^Gvs, Gs^Fdw, Wo, Wo, Ww, Ww, Ww, Ww, Ds, Ds, Gs^Fmw, Ds, Gs^Fmw, Hh^Em, Cte, 3 Kte, Cte, Gg^Fet, Hh^Fdw, Hh^Fdw, Hh^Fdw, Hh^Fdw, Hh^Fdw, Ds, Ds, Ww, Ds, Ds, Hh^Fmf, Hh^Fmf, Md
Gs^Fmw, Gs^Fmw, Gs^Fmw, Gs^Fmw, Gs^Vc, Gs^Fmw, Gs^Fmw, Gs^Fmw, Ds, Gs^Fdw, Gs^Fdw, Gs^Fdw, Ds, Gs^Fdw, Wo, Wo, Ww, Ww, Ww, Ww, Ww, Ds, Ww, Ww, Hh^Fdw, Cte, Cte, Cte^Edt, Gg^Gvs, Gg^Gvs, Gg^Gvs, Hh^Fdw, Hh, Gg, Ds, Ww, Ww, Ww, Ww, Ds, Ds, Ds
Gg^Gvs, Gg^Gvs, Gg^Gvs, Gs^Fmw, Gs^Fmw, Gd, Gs^Fmw, Gs^Fdw, Gs^Efm, Ds, Ds, Ds, Wo, Wo, Wo, Wo, Wo, Ww, Ww, Ww, Ww, Ww, Ww, Ww, Hh^Fdw, Hh^Fdw, Hh^Fdw, Gg^Gvs, Gg^Gvs, Gg^Efm, Gg^Efm, Hh^Fdw, Hh^Fdw, Hh^Fdw, Ds, Ww, Ww, Wo, Wo, Ww, Ww, Ww
Gg^Gvs, Gg^Gvs, Gg^Gvs, Gs^Fdw, Gs^Fmw, Gg^Gvs, Gs^Fmw, Gs^Fmw, Gs^Fmw, Ds, Ww, Ww, Wo, Wo, Wo, Wo, Ww, Ww, Wo, Wo, Wo, Ww, Wo, Hh^Vh, Hh^Fdw, Gg^Fet, Gg^Efm, Hh^Fdw, Hh^Fdw, Gg^Efm, Hh^Fdw, Hh^Fdw, Hh^Fdw, Hh^Fdw, Hh^Fmf, Ds, Ds, Ww, Wo, Wo, Wo, Wo
Gs^Fdw, Gs^Fdw, Gs^Fdw, Gs^Fdw, Gs^Fdw, Gg^Gvs, Gg^Gvs, Gd^Gvs, Gs^Fmw, Ds, Wo, Wo, Wo, Wo, Wo, Wo, Wo, Ww, Ww, Wo, Wo, Wo, Ww, Wo, Ds, Gg^Fet, Gg, Gg^Efm, Hh^Em, Hh^Fdw, Md, Hh^Fdw, Gg^Efm, Md, Md, Hh^Fmf, Ds, Ww, Ww, Wo, Wo, Wo
Ww, Ww, Ww, Gs^Efm, Ww, Ds, Ds, Ds, Ds, Ds, Ww, Wo, Ww, Ww, Wo, Wo, Wo, Wo, Wo, Ww, Wo, Wo, Ww, Ww, Ds, Gg^Efm, Gg^Efm, Hh^Em, Hh, Gg^Gvs, Md^Xm, Gs^Efm, Gs^Efm, Gg^Efm, Hh^Fmf, Gg^Efm, Hh^Fmf, Gg^Efm, Ww, Ww, Ww, Wo
Wo, Wo, Wo, Ww, Wo, Wo, Wo, Ww, Ww, Ww, Wo, Ww, Ww, Wo, Wo, Wo, Wo, Wo, Ww^Vm, Ww, Wo, Wo, Wo, Wo, Ww, Ds, Ds, Md, Gg^Gvs, Gg^Gvs, Md, Md, Md, Gg^Efm, Gg^Efm, Gg^Efm, Gg^Efm, Gg^Efm, Ww, Wo, Wo, Wo
Gg, Gg, Gg, Wo, Gg, Gs^Efm, Gs^Efm, Wo, Hh^Fdw, Ww, Ww, Wo, Wo, Wo, Ww, Ww, Ww, Ww, Wo, Wo, Ww, Wo, Wo, Wo, Ww, Md, Gs^Fdw, Ds, Gs^Fdw, Gg^Gvs, Gg^Efm, Gg^Efm, Gg^Efm, Gg^Efm, Gg^Efm, Md, Md, Gg^Efm, Ww, Wo, Wo, Wo
Hh^Fdw, Hh^Fdw, Hh^Fdw, Hh^Fdw, Gs^Efm, Gg, Gs^Efm, Gg^Fet, Hh^Fdw, Gg^Fet, Ww, Ww, Ww, Ww, Wo, Ww, Wo, Wo, Gg^Fet, Gg, Ww, Wo, Wo, Wo, Md, Md, Gs^Fdw, Gs^Fdw, Gs^Fdw, Gs^Fdw, Gg^Efm, Gs^Efm, Gg^Efm, Md, Gg^Efm, Md, Gg^Efm, Gg^Efm, Ww, Wo, Ww, Ww
Gs^Efm, Gs^Efm, Gs^Efm, Hh^Fdw, Gll^Fmf, Gg^Vo, Gs^Fdw, Hh^Fdw, Gs^Efm, Gs, Gg, Wo, Ds, Wo, Ds, Wo, Ds, Ds, Gg, Gg, Ww, Wo, Wo, Md^Xm, Md, Md, Hh, Hh, Gs^Fdw, Gs^Fdw, Gg^Efm, Gs^Fdw, Md, Gg^Efm, Md, Gg^Efm, Md, Gg^Efm, Ww, Ww, Wo, Wo
Gs^Efm, Gs^Efm, Gs^Efm, Gll^Fmf, Gll^Fmf, Gs^Fdw, Gg, Gs^Fdw, Gs^Efm, Hh^Fdw, Gs^Efm, Ds, Gs^Efm, Ds, Gs^Vh, Ds, Gg^Efm, Gg, Gg, Gs^Fdw, Md, Md, Md, Md, Md, Md, Gs^Fdw, Gs^Fdw, Gs^Fdw, Gg^Efm, Gg^Efm, Gs^Efm, Md, Md, Md, Gg^Efm, Md, Gg^Efm, Ds, Ww, Ww, Wo
Gg^Efm, Gg^Efm, Gg^Efm, Gs^Fdw, Gs, Gg, Cer, Gg, Gs^Efm, Gs^Efm, Gs^Efm, Gs^Efm, Gs^Efm, Gs^Efm, Gs, Gs, Gs, Gs, Gs^Em, Hh^Fdw, Md, Md, Md, Md, Md, Gg^Efm, Gs^Fdw, Gs^Fdw, Gg, Gg^Efm, Gg^Efm, Md, Md, Md, Md, Md, Hh, Gg^Efm, Hh^Fmf, Ds, Ww, Ww
Gs^Fdw, Gg, Gg^Efm, Gg, Gs^Efm, Cer^Edt, 4 Ker, Cer, Gs^Efm, Gg, Gs^Fdw, Gg, Gs^Efm, Gs^Efm, Gs^Efm, Gs, Gg^Fet, Gg^Fet, Md, Hh^Vhh, Md, Md, Md, Md, Md, Md, Gs^Fdw, Hh^Edt, Hh^Edt, Gs^Fdw, Gs^Fdw, Gg^Efm, Gg^Efm, Gg^Efm, Md, Hh, Hh^Fmf, Hh^Em, Hh^Fmf, Ds, Ds, Ds
Gg^Fet, Gg, Gg, Gs^Efm, Gg, Cer, Cer, Cer, Gg^Edt, Gs^Fdw, Gs^Fdw, Gll^Fdf, Gs, Gs^Efm, Gg, Gs, Gg^Fet, Md, Md, Md, Md, Md, Hh^Em, Md, Md, Gg, Gs, Gs, Gs, Hh^Fdw, Hh^Fdw, Gs^Fdw, Gs^Fdw, Gg^Efm, Md, Md, Gs^Fdw, Gs^Fdw, Hh^Fmf, Hh^Fdw, Md, Hh^Fdw
Gg^Fet, Gg^Fet, Gs^Vc, Gs^Fdw, Gg, Gs^Efm, Gs^Fdw, Gg, Gg, Gg^Edt, Gg, Gll^Fdf, Gll^Fdf, Gs^Efm, Gs^Efm, Gs, Md, Md, Md, Md^Xm, Hh, Hh^Em, Hh^Em, Hh^Em, Gs, Gs^Efm, Gs^Efm, Gg^Efm, Gg^Efm, Gs^Vc, Gg, Hh^Fdw, Cer, Cer, Cer, Gs^Fdw, Gs^Fdw, Gs^Vo, Hh^Fdw, Hh^Fdw, Md, Md
Gg, Gg, Gg^Efm, Gg, Gs^Fdw, Gs^Fdw, Gs^Efm, Gs^Efm, Gg^Efm, Gg^Edt, Gs^Vo, Gll^Fdf, Gll^Fdf, Gs, Gs^Efm, Gs, Gs^Fdw, Gg, Gs^Fdw, Gs^Fdw, Gg, Gg, Gs, Gs, Gg^Efm, Gs, Hh^Fdw, Gs^Fdw, Gs^Fdw, Gg, Gs^Fdw, Gs, Cer, 2 Ker, Cer^Edt, Gs^Fdw, Hh^Fdw, Gs^Fdw, Md, Md, Ds, Md
Gg, Hh^Fdw, Gs^Fdw, Gg^Em, Gs^Efm, Gs^Fdw, Gs^Fdw, Gg, Hh^Fdw, Gg^Efm, Gs, Gg, Gll^Fdf, Gs, Hh^Fdw, Gs^Efm, Gs^Efm, Gs, Gs, Gs^Efm, Gs, Gs, Gs, Gs, Gg^Efm, Ds, Ds, Hh^Fdw, Hh^Fdw, Hh^Fdw, Hh^Fdw, Hh^Fdw, Hh^Fdw, Cer, Gs^Fdw, Gs^Fdw, Md^Fdw, Md^Xm, Md, Ds, Ww, Ds
Hh^Fdw, Hh^Fdw, Gg, Hh^Fmf, Hh^Fmf, Hh^Fmf, Hh^Fdw, Hh^Fdw, Hh^Fdw, Gg, Gg, Gs, Gs^Fdw, Gs^Fdw, Gll^Fdf, Md, Gs^Fdw, Gs^Fdw, Gs, Gs, Gs, Gs, Gs^Fdw, Gs^Vh, Ds, Ds, Ww, Ds, Ds, Ds, Ds^Vo, Hh^Fmf, Hh^Fdw, Hh^Fdw, Gll^Fdf, Md^Xm, Md^Fdw, Md, Md, Ds, Ww, Ww
Hh^Fdw, Md, Md, Hh^Fdw, Hh^Fdw, Hh^Fdw, Hh^Fdw, Hh^Fdw, Gg^Efm, Gg^Efm, Gg, Gg^Efm, Gll^Fdf, Gll^Fdf, Gll^Fdf, Gs^Fdw, Gs^Fdw, Gs^Fdw, Gs^Fdw, Gll^Fdf, Gll^Fdf, Gs^Fdw, Gs^Fdw, Ds, Ww, Ww, Wo, Ww, Ww, Ww, Ww, Ds, Ds, Gll^Fdf, Md, Gll^Fdf, Md, Md^Fdw, Md, Ds, Ww, Wo
Md, Md^Xm, Md, Md, Md, Md, Md^Xm, Hh^Fdw, Hh^Fdw, Gg^Efm, Gll^Fdf, Gll^Fdf, Gll^Fdf, Gll^Fdf, Gll^Fdf, Gll^Fdf, Gll^Fdf, Gll^Fdf, Gll^Fdf, Gll^Fdf, Ds, Ds, Ds, Ds, Ww, Wo, Wo, Wo, Wo, Wo, Wo, Ww, Ww, Ds, Ds, Md, Ds, Md, Ds, Ds, Ww, Wo
Md, Md, Md, Md^Xm, Md, Md, Md, Md, Md, Hh^Fdw, Hh^Fdw, Gll^Fdf, Gll^Fdf, Gll^Fdf, Gll^Fdf, Gll^Fdf, Gll^Fdf, Gll^Fdf, Gll^Fdf, Ww, Wo, Ww, Wo, Ww, Wo, Wo, Wo, Wo, Wo, Wo, Wo, Wo, Wo, Wo, Ww, Ds, Wo, Ds, Ww, Ww, Wo, Wo
