Wo, Wo, Wo, Wo, Wo, Wo, Wo, Wo, Wo, Wo, Wo, Wo, Wo, Wo, Wo, Wo, Wo, Wo, Wo, Wo, Wo, Wo, Wo, Wo, Wo, Wo, Wo, Wo, Wo, Wo, Wo, Wo, Wo, Wo, Wo, Wo
Wo, Wo, Wo, Wo, Wo, Wo, Wo, Wo, Wo, Wo, Wo, Wo, Wo, Wo, Ww, Wo, Wo, Wo, Wo, Wo, Wo, Wo, Wo, Wo, Wo, Wo, Ww, Wo, Wo, Wo, Wo, Wo, Wo, Wo, Wo, Wo
Wo, Wo, Wo, Wo, Wo, Wo, Wo, Wo, Wo, Wo, Wo, Wo, Wo, Ww, Ww, Ww, Wo, Wo, Wo, Wo, Wo, Wo, Ww, Ww, Ww, Ww, Ww, Ww, Wo, Wo, Wo, Wo, Wo, Wo, Wo, Wo
Wo, Wo, Wo, Wo, Ww, Wo, Wo, Wo, Wo, Wo, Ww, Wo, Ww, Ww, Ww, Wo, Wo, Wo, Wo, Wo, Wo, Ww, Aa^Ii, Aa^Ii, Aa^Ii, Ds, Ds, Ww, Ww, Wo, Wo, Wo, Ww, Wo, Wo, Wo
Wo, Wo, Ww, Ww, Ww, Ww, Wo, Wo, Ww, Ww, Ww, Ww, Ww, Ww, Ww, Ww, Wo, Wo, Ww, Wo, Ww, Ww, Aa^Ii, Aa^Vha, Re, Aa^Ii, Aa^Ii, Ww, Wo, Wo, Wo, Wo, Ww, Wo, Wo, Wo
Wo, Wo, Wo, Ww, Ww, Ww, Ww, Ww, Ds, Ds, Aa, Ds, Ds, Ds, Ds, Ww, Ww, Ww, Ww, Ww, Ww, Ww, Aa^Ii, Re^Edt, Ms^Edt, Re^Ii, Ds, Ww, Wo, Ww, Ww, Ww, Ww, Wo, Wo, Wo
Wo, Wo, Wo, Ww, Ww, Ww, Ww, Ww, Aa^Fp, Aa, Aa^Vaa, Aa, Aa, Aa^Fp, Ss, Ds, Ds, Aa^Fp, Aa^Ii, Aa^Ii, Aa^Ii, Aa^Ii, Re^Fp, Re^Fp, Ss, Aa, Ds, Ww, Ww, Ww, Ww, Ww, Ww, Wo, Wo, Wo
Wo, Wo, Wo, Ww, Ww, Ww, Ww, Ds, Ms, Aa, Aa, Aa, Aa, Aa^Fp, Aa^Vla, Hh, Ms, Ms^Edt, Aa^Ii, Aa^Vha, Coa^Edt, Coa^Edt, Coa^Edt, Ss, Ss, Ds, Ds, Ww, Ww, Ww, Ww, Ww, Ww, Ww, Wo, Wo
Wo, Wo, Ww, Ww, Ww, Ww, Ds, Ds, Ds, Ms^Edt, Aa, Aa, Aa, Re, Re, Hh, Hh, Aa^Ii, Aa^Ii, Aa^Fpa, Coa, 2 Koa^Edt, Coa, Re^Fp, Ss, Ds, Ww, Ww, Ww, Ww, Ww, Ww, Ww, Ww, Ww, Wo
Wo, Wo, Ww, Ww, Ds, Ds, Ds, Ds, Aa^Fp, Ms, Aa, Aa, Aa, Mm^Ii, Ms^Ii, Mm, Mm, Hh, Hh, Aa^Fpa, Aa^Fpa, Coa, Aa, Re^Fp, Ss, Ds, Ww, Ww, Ww, Ww, Ds, Ds, Ds, Ds, Ds, Ww
Wo, Wo, Ww, Ds, Ds, Ai^Ii, Ai^Ii, Ai^Ii, Aa^Ve, Aa^Fp, Aa, Aa, Aa, Ms^Ii, Ms^Ii, Ms^Xm, Ms^Ii, Hh, Hh, Aa^Fpa, Aa^Vea, Aa^Fpa, Hh, Re^Fp, Re, Ds, Ww, Ww, Ww, Ww, Ds, Aa^Vaa, Aa^Fpa, Aa^Fpa, Aa^Fpa, Ds
Wo, Ww, Ww, Ds, Ai^Ii, Ai^Ii, Ai^Ii, Ai^Ii, Ai^Ii, Aa^Fp, Aa, Aa, Aa, Aa, Ms^Ii, Ms^Ii, Ms^Ii, Mm, Aa, Aa^Fpa, Aa^Fpa, Aa^Fpa, Aa^Fpa, Re^Fp, Aa^Fpa, Ds^Edt, Ds, Ds, Ds, Ds, Aa^Fpa, Aa^Fpa, Aa^Fpa, Aa^Fpa, Aa^Fpa, Aa
Ww, Ww, Ww, Ds, Ds, Ai^Ii, Aa^Fp, Ai^Ii, Ai^Ii, Ai^Ii, Aa^Fp, Cha, Aa, Aa, Mm, Mm, Mm, Hh, Aa^Fpa, Aa^Fpa, Aa^Fpa, Aa^Fpa, Aa^Ii, Re^Fp, Aa^Fpa, Aa^Fpa, Aa^Vha, Aa^Fpa, Aa^Fpa, Aa^Fpa, Hh^Ii, Aa^Fpa, Coa^Edt, Aa^Fpa, Aa^Fpa, Aa
Ww, Ww, Ds, Ds, Aa^Fma, Aa^Fma, 3 Kha, Aa^Fp, Cha, Re^Fp, Re^Fp, Aa^Fp, Aa^Fp, Aa, Aa, Aa^Fp, Aa^Fp, Aa^Fp, Aa^Fpa, Aa^Fpa, Aa^Ii, Aa^Ii, Aa^Edt, Aa^Fpa, Aa^Fpa, Aa^Fpa, Aa^Fpa, Aa^Fpa, Aa^Fpa, Coa^Edt, Coa, 4 Koa^Edt, Coa, Aa^Fpa, Aa^Fpa, Aa
Ww, Ww, Ds, Ds, Aa^Fma, Cha, Cha, Cha, Cha, Re^Fp, Aa^Fda, Aa^Fp, Aa^Fp, Aa, Aa^Fp, Aa^Fp, Re^Ve, Aa^Fp, Aa^Fp, Aa^Ii, Aa^Ii, Aa^Ii, Ss, Aa^Fpa, Aa^Fpa, Aa^Fpa, Hh, Aa^Fpa, Aa^Fpa, Coa^Edt, Coa^Edt, Coa^Edt, Aa^Fpa, Aa^Fpa, Aa^Fpa, Aa^Fpa
Ds, Ds, Aa^Fda, Aa^Fda, Aa^Fda, Cha, Aa^Fp, Cha, Aa^Vea, Re^Fp, Aa^Fda, Re^Fp, Re^Fp, Re, Aa^Fp, Aa^Fp, Gd^Fp, Gd^Fp, Aa^Ii, Aa^Ii, Aa^Ii, Aa^Fp, Ss, Aa^Fp, Hh, Hh, Hh, Hh, Hh, Aa^Fpa, Aa, Aa^Vha, Aa, Aa^Fpa, Aa^Fpa, Aa^Fpa
Wo, Aa^Fma, Aa^Fda, Rrc^Vhca, Aa^Fda, Aa^Fda, Aa^Fp, Aa^Fp, Aa^Fp, Aa^Fp, Aa^Fp, Aa^Fda, Cha, Aa^Fp, Ms, Aa^Ii, Ms^Ii, Aa^Ii, Aa^Ii, Aa^Edt, Aa^Ii, Ss, Hh, Aa^Fp, Hh, Hh^Ii, Mm^Ii, Mm^Ii, Mm^Ii, Mm^Ii, Aa^Fpa, Aa, Aa, Aa, Aa, Aa^Fpa
Ds, Aa^Fma, Aa^Fda, Aa^Fma, Aa^Fma, Aa^Fma, Aa^Fp, Aa^Fp, Aa^Ii, Aa^Ii, Aa^Ii, Aa^Ii, Aa^Fp, Aa^Fp, Aa^Fp, Ms, Ms^Ii, Aa^Ii, Aa^Ii, Aa^Ii, Aa^Ii, Hh, Aa^Vaa, Hh, Ha, Ha, Mm^Xm, Ms, Ms, Ms, Ms, Ms, Aa, Aa, Aa, Aa^Fpa
Ds, Aa^Fma, Aa^Fma, Aa^Fma, Aa^Fma, Aa^Fma, Aa^Ii, Cha, Aa^Ii, Aa^Ii, Aa^Ii, Aa^Ii, Aa^Fp, Aa^Fp, Aa^Fp, Aa^Ii, Aa^Ii, Ms^Ii, Aa^Ii, Aa^Ii, Aa^Ii, Aa^Ii, Ha, Mm, Mm, Mm, Mm, Mm, Ms, Ms^Xm, Ms, Ms, Ms, Aa, Aa, Aa
Ww, Ds, Ds, Aa^Fma, Aa^Ii, Aa^Ii, Aa^Ii, Aa^Ii, Aa^Ii, Aa^Ii, Aa^Ii, Aa^Ii, Aa^Fp, Aa^Ii, Aa^Ii, Aa^Vea, Ms^Ii, Cha, Cha, Aa^Ii, Re^Fma, Gs^Fp, Hh, Mm, Mm, Ww, Ww, Ww, Ww, Ms, Ms, Ms, Mm, Mm, Aa, Aa
Ww, Ww, Ww, Ds, Ds, Aa^Ii, Aa^Ii, Aa^Ii, Aa^Ii, Aa^Ii, Aa^Ii, Aa^Ii, Aa^Ii, Aa^Ii, Aa^Ii, Rb^Fp, Aa, Kha, Cha, Re^Fma, Re^Fma, Re^Fma, Aa^Feta, Aa^Fma, Ww, Ww, Ww, Ww, Ww, Mm^Ii, Mm^Ii, Ms, Ha, Mm, Mm, Aa
Ds, Ds, Ds, Ds, Ww, Aa^Ii, Aa^Ii, Aa^Ii, Aa^Ii, Aa^Ii, Aa^Fpa, Aa^Fp, Aa^Ii, Aa^Ii, Aa^Ii, Rb^Fp, Aa, Aa, Aa, Re^Fma, Re^Fma, Re^Fma, Gd^Fp, Ww, Ww, Ai, Ai, Ww, Ai, Mm^Ii, Mm^Ii, Ha, Ha, Ha, Aa, Aa
Aa, Aa, Ds, Ww, Ww, Ds, Aa^Ii, Aa^Ii, Aa^Ii, Aa^Fpa, Aa, Aa^Fp, Aa^Fp, Aa^Ii, Aa^Ii, Rb^Fp, Aa, Aa, Re^Fp, Re^Fp, Re^Fma, Re^Fma, Re^Fma, Ww, Aa, Ai, Ai, Ai, Ai, Ai, Mm^Ii, Re, Re, Re, Aa, Aa
Aa, Aa, Ms^Ii, Ds, Ds, Ww, Ds, Aa^Ii, Aa^Ii, Aa^Fpa, Aa^Fp, Aa^Fp, Aa, Aa^Fp, Ai^Ii, Rb^Fp, Aa, Aa, Re^Fp, Re^Fp, Re^Fma, Re^Fma, Aa, Aa^Vaa, Ww, Re, Ai, Ai, Ai, Ms^Ii, Aa, Aa, Aa, Aa, Aa, Aa
Aa, Aa, Aa, Ms^Ii, Ds, Ww, Ww, Ds, Aa^Ii, Aa^Fpa, Aa^Fp, Aa, Aa, Ai^Ii, Aa, Ai^Ii, Ai^Ii, Aa^Edt, Re^Fma, Re^Fma, Re^Fma, Aa, Aa, Aa, Gs^Edt, Gs, Ai, Ms, Aa, Ms^Vh, Aa, Aa, Aa^Fp, Aa, Aa, Aa
Aa, Aa, Aa, Aa, Aa, Ww, Ww, Ds, Aa^Fpa, Aa^Fp, Aa, Aa, Aa, Aa, Hh, Ai^Ii, Re^Fma, Re^Fma, Ai, Ai, Ai, Aa, Re^Ii, Re^Ii, Re^Ii, Re^Ii, Aa, Ms, Aa, Aa, Aa, Aa^Fp, Aa^Fp, Aa, Aa, Aa
Aa^Fpa, Aa^Vaa, Aa, Aa^Fpa, Aa^Fpa, Aa^Fpa, Aa^Fpa, Aa^Fpa, Aa^Fpa, Aa^Ve, Aa^Fp, Hh, Ms, Mm, Ms, Ha, Re^Fp, Re^Fp, Ai, Ai, Ai, Ai, Aa, Aa, Aa, Aa, Aa, Aa, Mm, Mm, Ms, Mm, Aa, Aa, Aa, Aa
Aa^Fpa, Aa, Aa, Aa, Aa, Aa^Fpa, Aa^Fpa, Aa^Fpa, Ms, Aa^Fp, Ms, Ha, Mm, Mm, Ms^Xm, Mm, Hh, Re^Fp, Ai, Ai, Ai, Aa, Aa, Aa, Re, Aa, Aa, Aa, Mm, Ms, Ms, Mm, Ms, Aa, Aa, Aa
Aa^Fpa, Aa^Fpa, Aa, Aa, Aa, Aa^Fpa, Aa^Fp, Ms, Ms, Ms^Xm, Ms, Mm, Mm, Ms, Ms, Ms, Mm, Re^Fp, Re^Fp, Ai, Ai, Ai, Aa, Aa, Aa, Re^Edt, Aa^Edt, Aa, Mm, Mm, Ms, Ms^Xm, Ms, Ha, Aa, Aa
Aa^Fpa, Aa^Fpa, Aa^Fpa, Aa, Aa^Fp, Aa^Fpa, Ha^Vhha, Ms, Ms, Ms, Ms, Ms, Mm, Mm, Mm, Mm, Hh, Re^Fp, Hh^Ve, Re^Fp, Aa, Ai, Aa, Ms, Aa^Vca, Re^Edt, Re^Edt, Aa, Mm, Mm, Ms, Ms, Ms, Ha, Aa, Aa
Aa^Fpa, Aa^Fpa, Aa^Fpa, Aa, Aa^Fp, Aa^Fp, Aa, Ms, Ms, Ms, Ms, Ms, Hh, Mm, Mm, Mm, Ai, Ai, Ai, Re^Fp, Aa, Aa, Ms, Ha, Aa^Fp, Re^Ii, Re^Ii, Aa, Mm, Ms, Mm, Ms, Ms, Aa, Aa, Aa
Ww, Aa^Fpa, Aa^Ii, Re, Re^Edt, Ha^Ii, Ms, Ms, Ms, Ms^Xm, Ms, Aa^Ii, Aa^Ii, Hh, Mm, Hh, Ai, Ai, Aa^Ii, Re^Fp, Aa, Ha, Ms, Ms, Ms, Ms, Ms, Mm, Mm, Mm, Mm, Mm, Aa, Aa, Aa, Aa
Ww, Ds, Aa^Ii, Re, Aa^Ii, Ha^Ii, Ha^Ii, Ms, Ha^Ii, Ms, Aa^Ii, Aa^Ii, Aa^Ii, Aa^Fp, Aa, Ai, Ai, Ai, Aa^Ii, Re^Fp, Ha, Mm, Ms, Ms, Ms, Ms^Xm, Ms, Ms, Mm, Mm, Mm, Hh^Ii, Aa, Aa, Aa, Ww
Ww, Ds, Aa^Ii, Aa^Ii, Re^Edt, Re^Ii, Ds, Ha^Ii, Aa^Ii, Aa^Ii, Aa^Ii, Aa^Ii, Cea, Cea, Cea, Aa^Fpa, Re, Aa^Ii, Aa^Ii, Ha, Ha, Mm, Ms, Ms, Ms, Ms, Ms, Ms, Mm, Mm, Aa, Aa, Aa, Aa, Ww, Ww
Ww, Ww, Ds, Re^Edt, Gd^Ii, Ds, Ww, Aa^Fpa, Aa^Fpa, Aa^Ii, Aa^Fpa, Aa^Fp, Cea, 1 Kea, Cea, Aa^Fpa, Ai, Re, Gd^Edt, Ha, Gd^Ii, Aa^Fpa, Ha, Mm, Ms, Ms, Mm, Hh^Ii, Aa, Aa, Aa, Aa, Aa, Ww, Ww, Wo
Wo, Ww, Ww, Ds, Ds, Ww, Ww, Ds, Ww, Aa^Ii, Aa^Fpa, Aa^Fp, Aa^Fpa, Cea, Hh^Fp, Aa^Fp, Ai, Ai, Aa^Fpa, Gd^Ii, Aa^Fpa, Aa^Fpa, Aa, Aa, Aa, Aa, Aa, Aa, Aa, Ds, Ww, Ww, Wo, Wo, Wo, Wo
Wo, Ww, Ww, Ww, Ww, Ww, Ww, Ww, Ww, Aa^Fpa, Aa^Fpa, Aa^Fpa, Aa^Fpa, Aa^Fp, Aa^Vla, Aa^Fp, Aa^Fpa, Ai, Aa^Fp, Aa^Fpa, Ds, Aa^Fpa, Aa, Aa, Aa, Aa, Aa, Aa, Aa, Ds, Ww, Wo, Wo, Wo, Wo, Wo
Wo, Wo, Wo, Wo, Wo, Wo, Ww, Ww, Ds, Aa, Hh^Fp, Aa^Fpa, Aa^Fpa, Aa^Fpa, Aa^Fpa, Aa^Fpa, Aa^Fpa, Aa^Fp, Aa^Fp, Ds, Ww, Ds, Re^Ii, Mm, Aa, Aa, Aa, Aa, Aa, Ds, Ww, Wo, Wo, Wo, Wo, Wo
Wo, Wo, Wo, Wo, Ww, Ww, Ww, Ds, Gs^Edt, Re^Fp, Hh^Edt, Aa^Fpa, Aa^Fpa, Aa^Fp, Aa^Fp, Aa, Aa, Aa, Aa^Fp, Ww, Ww, Ww, Ds, Re, Re, Aa, Aa, Aa, Ds, Ww, Ww, Wo, Wo, Wo, Wo, Wo
Wo, Wo, Wo, Ww, Ww, Ww, Wo, Ds, Re^Fp, Re^Fp, Re^Fp, Re^Fp, Re^Fp, Ds, Wo, Ww, Ww, Ww, Ww, Ww, Ww, Ww, Ww, Ds, Ds, Ds, Ds, Ds, Wo, Ww, Wo, Ww, Wo, Wo, Wo, Wo
