Wo, Wo, Wo, Wo, Wo, Wo, Ww, Ww, Aa^Fma, Aa^Fma, Ai, Aa^Fma, Aa^Fpa, Aa^Fpa, Aa^Fpa, Aa^Fpa, Aa^Fpa, Aa^Fpa, Aa^Fpa, Aa, Aa, Aa, Aa, Aa, Aa, Ai, Ai, Ai, Ai, Ai, Ai, Ww, Ww, Wo, Wo, Wo, Wo, Wo
Wo, Wo, Wo, Wo, Wo, Wo, Ww, Ww, Aa, Aa^Fma, Ai, Aa^Fpa, Aa^Fpa, Aa^Fpa, Aa^Fpa, Aa^Fpa, Aa^Fpa, Aa^Fpa, Aa, Aa, Aa, Aa, Aa, Aa, Aa, Aa, Aa, Aa, Aa^Fp, Aa, Ai, Ai, Ww, Ww, Wo, Wo, Wo, Wo
Wo, Wo, Wo, Wo, Wo, Wo, Ww, Ww, Aa, Aa, Ai, Aa^Fpa, Aa^Fpa, Ai, Ai, Ai^Ve, Aa^Fpa, Aa^Fpa, Aa, Aa^Fma, Aa, Aa, Aa, Aa, Aa^Fp, Aa^Fp, Aa^Fp, Aa^Fp, Aa^Fp, Aa^Fp, Ai, Ai, Ai, Ww, Wo, Wo, Wo, Wo
Wo, Wo, Wo, Wo, Wo, Wo, Ww, Ds, Aa, Aa, Ai, Aa, Ai, Ai, Ai, Aa^Fpa, Ha, Ha, Aa, Aa, Ha, Aa, Aa^Fp, Aa^Fp, Aa, Aa, Ha, Aa^Fp, Ai, Aa^Fp, Ai, Ai, Ai, Ww, Ww, Wo, Wo, Wo
Wo, Wo, Wo, Wo, Wo, Wo, Ww, Aa, Aa, Ai, Ai, Ai, Aa, Aa, Ai, Ha, Ha, Ha, Ha, Ha, Ha, Ha, Aa^Fp, Aa, Aa, Aa, Ha, Ha, Ha, Ai, Ai, Aa, Ai, Ai, Ww, Wo, Ww, Wo
Wo, Wo, Wo, Wo, Wo, Wo, Ww, Aa, Aa, Aa, Ai, Ai, Ai, Aa, Ha, Ai, Ha, Ha, Ha, Ha, Ha, Ha, Aa^Fp, Ha, Ha, Ha, Ha, Ha, Ha, Ha, Aa^Fp, Aa^Fp, Ai, Ai, Ww, Ww, Ww, Ww
Wo, Wo, Wo, Wo, Ww, Ww, Aa, Aa, Cea, Aa, Aa^Vca, Ai, Ai, Ha, Ha, Ha, Ha, Ha, Ha, Ha, Aa^Fp, Aa^Fp, Ha, Ha, Ha, Ha, Ha, Ha, Ha, Aa^Fp, Aa^Fp, Aa^Fp, Aa^Fp, Ww, Aa^Fp, Ai, Ww, Wo
Ww, Wo, Ww, Ww, Aa, Aa, Aa, Cea, 1 Ket, Cea, Aa, Ai, Ha, Ha, Ha, Ha, Aa, Aa, Aa, Ha, Aa^Fp, Aa^Fp, Aa^Fp, Ha, Ha, Ha, Ha, Ha, Ha, Ha, Aa, Aa^Ve, Aa^Fp, Aa^Fp, Ai, Ai, Ww, Wo
Ww, Ww, Ww, Ww, Aa, Aa, Rb, Cea, Cea, Cea, Rb, Aa, Aa, Aa, Aa, Ha, Aa, Aa, Aa, Aa^Fp, Aa, Aa^Fp, Aa^Fp, Ha, Aa^Fp, Aa^Fp, Ha, Ha, Ha, Ha, Aa, Aa^Fp, Aa^Fp, Aa^Fp, Aa^Ve, Ai, Ww, Ww
Aa, Ww, Ds, Ww, Ds, Re, Rb, Rb, Rb, Rb, Rb, Aa, Ai, Aa, Aa, Ha, Aa, Aa, Ha, Aa^Fp, Aa^Vha, Aa, Aa, Aa^Fp, Aa^Fp, Ha, Ha, Ha, Cva, Ha, Ha, Aa^Fp, Aa, Ai, Ai, Ai, Ww, Ww
Aa, Aa, Aa, Aa, Rb, Rb, Rb, Aa, Aa, Rb, Ai, Ai, Aa, Aa, Aa, Aa, Aa, Aa, Aa, Aa, Aa, Aa, Aa, Aa^Fp, Aa, Ha, Ha, Cva, Kva, Cva, Ha, Aa^Fp, Aa, Ai, Ai, Ai, Ww, Ww
Ai, Ai, Ai, Aa, Aa, Aa, Aa, Aa, Rb, Rb, Ai, Rb, Aa, Aa, Rb, Aa, Aa, Aa, Aa, Ha, Aa, Aa, Aa, Aa, Ai, Aa, Aa, Cva, Cva, Cva, Ha, Ha, Aa, Ww, Ww, Ww, Ww, Ww
Ai, Aa, Aa, Aa, Aa, Aa, Aa, Aa, Aa, Aa, Aa, Aa, Aa, Aa, Aa, Rb, Aa, Aa, Aa, Aa, Aa, Aa^Fpa, Ai, Ai, Ai, Ai, Aa^Fp, Ha, Ha, Ha, Ha, Ha, Ha, Aa, Aa, Aa, Aa, Ww
Aa, Aa, Aa, Aa, Aa, Aa, Aa, Aa, Aa, Aa, Rb, Aa, Aa, Aa, Rb, Rb, Aa, Aa, Re, Aa, Aa^Fma, Ai, Ai, Ai, Ai, Ai, Aa^Fp, Ha, Ha, Aa^Fp, Aa^Vea, Aa^Fp, Ha, Ha, Ha, Ha, Ha, Aa
Aa, Aa, Aa, Aa, Aa, Aa, Aa, Aa, Aa^Vla, Rb, Rb, Aa, Aa, Aa, Rb, Aa, Aa, Rb, Rb, Aa, Aa^Fma, Aa^Fma, Ai, Ai, Ai, Aa^Fp, Aa^Fp, Ha, Aa^Fp, Aa^Fp, Aa, Aa^Fp, Aa^Fp, Ha, Ha, Ha, Ha, Ha
Aa, Aa, Aa, Aa, Aa, Aa, Ai, Ai, Ai, Rb, Rb, Aa, Aa, Aa, Rb, Ai, Ai, Aa, Aa, Aa, Aa^Fma, Aa^Fma, Aa^Fma, Ai, Aa^Fp, Aa^Fp, Aa^Fp, Aa^Fp, Aa^Fp, Aa^Fp, Aa^Fp, Aa^Fp, Aa^Fp, Aa^Fp, Aa^Fp, Ha, Ha, Ha
Aa, Aa, Aa, Aa, Aa, Aa, Ai, Ai, Ai, Rb, Rb, Aa, Aa, Aa, Rb, Rb, Ai, Rb, Aa, Aa, Aa^Fma, Aa^Vla, Aa, Aa^Wm, Aa^Wm, Aa^Fp, Aa^Fp, Aa^Fp, Aa^Fp, Aa^Fp, Aa^Fp, Aa^Fp, Aa^Fp, Aa^Fp, Aa, Aa, Aa, Ha
Aa^Fpa, Aa^Fpa, Aa, Aa^Vaa, Aa, Aa, Aa, Ai, Rb, Rb, Ha, Ha^Ve, Aa, Re, Aa, Rb, Rb, Ai, Ai, Aa, Aa, Aa, Aa^Fma, Aa, Aa, Aa^Wm, Aa^Wm, Aa^Fp, Aa^Fp, Aa^Fp, Aa^Fp, Aa^Fp, Aa^Fp, Aa, Aa, Aa, Aa, Aa
Aa^Fpa, Aa^Fpa, Aa^Fpa, Aa, Aa, Aa, Aa, Rb, Rb, Re, Rb, Ha, Aa, Aa, Aa, Aa, Rb, Ai, Aa, Aa, Aa^Fma, Aa^Fma, Aa^Fma, Aa^Fma, Aa^Fma, Aa, Aa, Aa^Fp, Aa^Fp, Aa^Fp, Aa^Fp, Aa^Fp, Aa^Fp, Aa^Fp, Aa, Aa, Aa, Aa
Aa, Aa^Fpa, Aa^Fpa, Aa^Fpa, Aa^Fpa, Aa, Aa, Aa, Rb, Rb, Rb, Rb, Rb, Aa, Rb, Aa, Rb, Rb, Aa, Aa^Fma, Aa^Fma, Aa^Fma, Aa^Fma, Aa^Fma, Aa^Fma, Aa, Aa^Fma, Aa^Wm, Aa, Aa^Fp, Aa, Aa^Fp, Aa^Fp, Aa, Ms, Aa, Aa, Aa
Ds, Aa, Aa^Fpa, Aa^Fpa, Aa, Aa, Aa, Aa, Ai, Re, Aa^Fma, Rb, Rb, Rb, Rb, Rb, Rb, Aa, Aa^Fma, Aa^Fma, Aa^Wm, Aa^Fma, Aa^Fma, Aa^Fma, Aa^Fma, Aa^Fma, Aa, Aa, Aa^Fma, Aa, Aa, Aa, Aa, Ms, Ms, Aa, Aa, Aa
Ds, Ds, Aa, Aa^Fpa, Aa, Aa, Ha, Ha, Aa, Aa, Aa, Aa, Rb, Rb, Rb, Rb, Aa^Fma, Aa^Fma, Aa^Fma, Aa^Fma, Ai, Aa^Fma, Aa^Feta, Aa^Fda, Aa^Fda, Aa^Fma, Aa^Fma, Aa^Fma, Aa^Fma, Aa, Aa, Aa, Aa, Aa, Ms, Ms, Ms, Aa
Ds, Ds, Aa, Aa^Fpa, Aa, Aa, Cea, Cea, Cea, Aa, Aa, Aa, Aa, Aa, Ai, Rb, Rb, Aa^Fma, Ai, Ai, Rb, Ai, Ai, Aa^Fda, Ai, Ai, Rb, Rb, Aa, Aa, Aa, Aa, Aa, Aa^Vh, Ms, Ms, Ms, Ms
Ds, Aa, Aa^Fma, Aa, Aa, Ha, Cea, 3 Kha, Cea, Aa, Aa, Aa, Aa, Ai, Rb, Rb, Rb, Ai, Ai, Rb, Rb, Rb, Rb, Ai, Ai, Ai^Vla, Ai, Rb, Rb, Ms, Ms, Aa, Ms, Ms, Ms, Ms, Ms, Ms
Ww, Ds, Aa^Fma, Aa, Aa, Ha, Aa, Cea, Aa, Aa, Aa, Aa^Vh, Aa, Ai, Rb, Rb, Rb, Re, Re, Re, Re, Rb, Rb, Rb, Ai, Ai^Edt, Rb, Ai, Re, Ms, Qxu, Ms, Ms, Ms, Ms, Ms, Ms, Ms
Ww, Ds, Aa, Aa, Ha, Ha, Aa, Aa, Ai, Aa^Edt, Ai, Aa, Aa, Rb, Rb, Ms, Ms, Rb, Aa^Vla, Ai, Ai, Ai, Ai, Rb, Rb, Rb, Rb, Rb^Edt, Re, Qxu^Ii, Qxu^Ii, Ms, Ms, Ms, Aa, Ms, Aa, Aa^Fma
Wo, Ww, Aa, Aa, Aa, Ha, Aa, Aa, Aa, Ai, Ai, Ai, Ai, Rb, Ai, Rb, Ms, Ms, Ms, Ms, Ms, Ai^Edt, Ms, Ai, Ai, Rb, Re, Re, Re, Re, Mv, Ms, Mv, Ms, Ms, Aa, Aa, Aa^Fma
Wo, Ww, Ww, Aa, Aa, Aa, Aa, Aa, Aa, Aa, Aa, Aa, Aa, Ai, Ai, Ai, Aa, Aa, Ms, Ms, Ms, Ms, Ms, Ms, Ai, Rb^Edt, Rb^Edt, Re, Cfr^Ecf, Cfr^Ecf, Cfr, Ms, Qxu^Ii, Ms, Ms, Ms, Ms, Aa
Ww, Ww, Aa, Aa, Aa, Aa, Aa, Aa, Aa, Aa, Aa, Aa, Aa, Aa, Ai, Aa, Aa, Aa, Aa, Ms, Ms, Ms, Ms, Ms, Mv, Mv, Rb^Edt, Rra^Fma, Cfr^Ecf, 2 Kfr, Cf^Edt, Ms, Qxu^Ii, Ms, Mv, Mv, Ms, Aa
Wo, Ww, Aa, Aa, Aa, Aa, Aa, Aa, Aa^Fma, Aa, Aa, Aa, Aa, Ai, Aa, Aa, Aa, Aa, Aa, Aa^Edt, Aa^Edt, Ms, Ms, Ms, Ql, Mv, Re, Rb^Edt, Ql, Cfr, Qxu, Qxu, Mv^Edt, Ql^Edt, Ms, Ms, Aa, Aa
Ww, Ww, Ds, Aa, Aa, Aa, Aa, Aa^Fma, Ai, Aa^Fma, Aa, Aa, Aa, Ai, Aa^Vla, Aa, Aa, Aa, Aa, Aa^Edt, Ms, Ms, Ms, Ql, Qxu, Ql, Re, Rb^Edt, Re^Fma, Mv, Ql, Mv^Ii, Aa, Aa, Aa, Aa, Ww, Ww
Wo, Ww, Ww, Ds, Aa^Fpa, Aa, Aa, Aa, Aa, Aa, Aa, Aa, Aa, Ai, Aa, Aa, Aa, Aa, Aa, Aa, Aa, Ms, Ms, Mv, Qxu, Ql, Rb^Fma, Rb^Fma, Re^Fma, Ai, Aa^Edt, Aa, Ww, Ds, Ww, Ww, Ww, Ww
Wo, Ww, Ww, Ww, Ww, Ai, Aa, Aa, Aa, Aa, Ai, Aa, Aa, Aa, Aa, Aa, Aa, Aa, Aa, Aa, Aa, Aa, Ha, Aa, Rb, Qxu, Mv, Mv, Re, Re^Fma, Aa, Aa, Ww, Ww, Ww, Ww, Wo, Wo
Wo, Wo, Wo, Ww, Ww, Ww, Ww, Ds, Ww, Ww, Ww, Aa, Aa, Aa, Aa, Aa, Aa, Aa, Aa, Aa, Aa, Aa, Ha^Vhh, Aa, Aa, Aa^Edt, Aa^Edt, Aa^Edt, Aa^Vh, Aa, Aa^Edt, Ww, Ww, Ww, Wo, Wo, Wo, Wo
Wo, Wo, Wo, Wo, Wo, Ww, Ww, Ww, Ww, Ww, Ww, Ai, Aa, Aa, Aa, Aa, Aa, Aa, Aa, Aa, Aa, Ha, Aa^Fpa, Aa, Aa, Aa, Aa, Aa, Ds, Ds, Ds, Ds, Ww, Wo, Wo, Wo, Wo, Wo
Wo, Wo, Wo, Wo, Wo, Ww, Ww, Ww, Ww, Ww, Ww, Ww, Aa^Fpa, Aa, Aa, Aa, Ha, Aa, Aa, Aa, Aa, Ha, Aa^Fpa, Aa, Aa, Aa, Rb, Ha, Ds, Ww, Ww, Ww, Wo, Wo, Wo, Wo, Wo, Wo
Wo, Wo, Wo, Wo, Wo, Ww, Wo, Ww, Ww, Ww, Ww, Ww, Ds, Aa, Aa^Fpa, Aa, Aa, Ha, Rb, Rb, Rb, Rb, Rb, Rb, Rb, Rb, Rb, Ds, Ds, Ww, Ww, Wo, Wo, Wo, Wo, Wo, Wo, Wo
Wo, Wo, Wo, Wo, Wo, Wo, Wo, Wo, Wo, Wo, Ww, Ww, Ds, Ds, Ds, Aa, Aa^Fpa, Aa, Aa, Aa, Aa, Rb, Rb, Ds, Rb, Ds, Rb, Ds, Wo, Ww, Ww, Wo, Wo, Wo, Wo, Wo, Wo, Wo
