Isa, Isa, Isa, Isa, Isa, Qxua, Qxua, Rra, Rra, Ai, Ai, Ai, Aa, Aa, Aa, Ms, Ms, Isa, Isa, Isa, Isa, Isa, Isa, Isa, Isa^Fetd, Isa^Fetd, Isa^Fetd, Isa^Fetd, Ai, Ai, Aa, Aa, Aa, Aa, Aa, Aa, Aa, Aa, Aa, Aa, Aa, Aa, Aa, Aa
Isa, Isa, Isa, Isa, Aa^Voa, Qxua, Rra, Rra, Rra, Ai, Ai, Ai, Aa, Aa, Aa, Rb, Ms, Isa, Isa, Isa, Isa, Isa, Isa, Isa, Isa^Fetd, Isa^Fetd, Isa^Fetd, Isa^Fetd, Ai, Ai, Aa, Aa, Aa, Aa, Aa, Aa, Aa, Aa, Aa, Aa, Aa, Aa, Aa, Aa
Isa, Isa, Isa, Isa, Qxua, Qxua, Isa, Rra, Rra, Ai, Rra^Em, Aa, Aa, Aa, Ms, Aa, Ms, Isa, Isa, Isa, Rb, Isa, Isa, Isa, Isa^Fetd, Isa^Fetd, Isa^Fetd, Isa^Fetd, Ai, Ai, Aa^Fma, Aa, Aa, Aa^Ve, Aa, Aa, Cer, Rb, Rb, Aa, Aa, Aa, Aa, Aa
Isa, Isa, Isa, Qxua, Isa, Isa, Isa, Isa, Rra^Em, Rra^Em, Ms, Aa, Ms, Ms, Ms, Ms, Isa, Isa, Isa, Isa, Isa, Isa, Isa, Isa^Vhh, Isa^Fetd, Isa^Fetd, Isa^Fetd, Isa^Fetd, Isa^Fetd, Mv, Isa^Fetd, Isa, Isa, Isa, Isa, Cer^Edt, 2 Ker, Cer, Aa, Aa, Isa, Aa, Aa, Aa
Rra, Isa, Rra^Fetd, Isa, Isa, Isa, Rra^Fetd, Rra^Fetd, Ms, Rra^Em, Ms, Ms, Ms, Ms, Isa, Qxua, Ms, Isa, Isa, Isa, Isa, Isa, Isa, Isa, Isa^Fetd, Isa^Fetd, Isa^Fetd, Isa^Fetd, Isa^Fetd, Isa^Fetd, Isa^Fetd, Isa, Isa, Isa, Isa, Cer^Edt, Cer^Edt, Cer, Isa, Isa, Isa, Isa, Isa, Isa
Aa, Rra, Rra, Rra^Fetd, Rra^Fetd, Rra^Fetd, Rra^Fetd, Rra^Fetd, Ms, Rra^Fetd, Ms, Ai^Es, Ms, Ms, Isa, Qxua, Qxua, Ms, Ms, Isa, Ms, Ms, Ha^Fetd, Isa, Isa, Isa^Fetd, Isa, Isa^Fetd, Isa, Isa^Fetd, Isa, Isa^Fetd, Isa^Fetd, Aa, Ai, Isa, Isa, Isa, Isa, Isa^Vh, Ai, Ai, Ai, Ai
Aa, Aa, Rra^Ve, Rra^Fetd, Rra^Fetd, Rra^Fetd, Rra^Fetd, Ms, Ms, Ms, Ms, Ms, Ms, Ms, Mv, Qxua, Isa, Ms, Ms, Ms, Ms, Ms, Isa, Isa, Isa, Isa, Isa, Isa, Isa, Isa, Isa, Isa^Fetd, Isa^Fetd, Aa, Aa, Isa^Edt, Ai, Isa, Isa^Ii, Isa, Isa, Isa^Ii, Ai, Ai
Aa, Aa, Aa, Rra^Esa, Rra, Rra, Rra, Ms, Ms, Ms, Ms, Ms, Ms, Qxua, Isa, Isa, Isa, Isa, Isa, Ms, Isa, Ms, Ms, Isa, Ha, Ha, Ha, Ha, Isa, Isa, Isa, Isa, Aa, Isa^Fetd, Isa^Fetd, Ai, Isa, Isa, Isa, Isa, Ai, Ai, Isa, Isa
Aa, Aa, Qxua, Rra, Aa, Rra, Aa, Rra^Ii, Rra, Ms, Ms, Ms, Ms, Ms, Isa, Isa, Isa, Isa, Aa, Isa, Ms, Ms, Ms, Ms, Ha^Voa, Ha, Ha, Ha, Ha, Isa, Isa, Isa, Isa, Isa, Isa, Isa, Isa, Isa, Ai, Ai, Ai, Isa, Isa, Isa
Aa, Aa, Aa, Aa, Aa, Aa, Isa, Isa, Rb^Es, Rra^Vh, Ms, Ms, Ms, Isa, Isa, Isa, Isa, Aa, Aa, Isa, Ms, Ms, Ms, Ha, Ha, Ha, Ha, Ha, Ha, Ha, Isa, Isa^Vhc, Isa, Isa, Isa, Isa, Ai, Ai, Isa, Ai, Ai^Edt, Ai, Ai, Isa
Aa, Aa, Aa, Aa, Aa, Isa, Ai, Isa, Isa, Rb, Ce, Rb, Isa, Isa, Isa, Isa, Isa, Aa, Isa, Isa, Isa, Ms, Ha, Ha, Ha, Ha, Ha, Ha, Aa, Isa, Isa, Isa, Isa, Isa, Aa, Isa, Ai, Isa, Isa, Ai, Ai, Ai, Isa, Isa
Ds, Aa, Ds, Aa, Ds, Ai, Isa, Isa, Isa, Ce, 1 Ke, Ce, Isa, Isa, Isa, Isa^Vct, Ai, Aa, Isa, Ha^Vhc, Ha, Isa, Ha, Ha, Ms, Ai, Ai, Ai, Ai, Aa, Ai, Ai, Isa^Ii, Isa, Isa^Ii, Isa, Isa, Isa, Isa, Ai, Ai, Ai, Isa, Isa
Ww, Ds, Ww, Ds, Ww, Ds, Ds, Isa, Isa, Ce, Ce, Ce, Isa, Ai, Isa^Ii, Ai, Ha, Isa, Isa, Isa, Ha, Ha, Ms, Ha, Ms, Ms, Ai, Ai, Ai, Ai, Ai, Ai, Isa^Ii, Isa^Ii, Isa^Ii, Isa, Isa, Isa, Isa^Ii, Isa, Isa, Ai, Ai, Ai
Ww, Ww, Ww, Ww, Ww, Ww, Ds, Ds, Ds, Isa, Isa, Isa, Isa, Isa, Isa, Ai, Isa, Isa, Isa, Isa, Isa, Ms, Ms, Ms, Ai, Ai, Chr, Chr^Edb, Chr^Edb, Ai, Isa^Ii, Isa^Ii, Isa, Isa^Fetd, Isa^Fetd, Isa^Fetd, Isa^Fetd, Isa, Isa, Isa^Ii, Isa, Isa, Isa, Isa
Ww, Ww, Ww, Ww, Ww, Ww, Ww, Ds, Ww, Ds, Ds, Isa, Isa, Isa, Isa, Isa, Isa, Isa, Ai, Aa, Aa, Isa, Isa, Ai, Isa^Ii, Isa^Ii, Chr, 3 Khr, Chr^Edb, Isa^Ii, Isa^Ii, Isa, Isa, Isa^Edt, Isa^Fetd, Isa^Fetd, Ai, Ai, Isa^Ii, Isa^Ii, Isa, Isa, Isa, Isa
Wo, Wo, Wo, Ww, Ww, Ww, Ww, Ww, Ww, Ww, Ds, Isa, Isa, Ai, Ai, Isa^Vo, Rra, Ai, Ai, Aa, Isa, Isa, Isa, Isa, Isa, Isa, Isa, Chr, Isa^Ii, Isa^Ii, Isa, Isa^Ii, Isa, Isa^Vhc, Isa, Ai, Qxua, Ai, Ai, Isa^Ii, Isa, Isa, Isa, Isa
Wo, Wo, Wo, Ww, Ww, Ww, Wo, Ww, Ww, Ww, Ds, Ds, Isa, Isa, Isa, Isa, Isa, Rra, Rra, Ai, Ai, Isa, Isa^Esa, Isa, Isa^Vhcr, Isa^Ii, Isa, Isa, Isa, Isa, Isa, Isa, Isa^Ii, Isa, Ai, Ai, Isa, Qxua, Mv, Ai, Ai, Isa, Isa, Isa
Wo, Wo, Wo, Ww, Ww, Wo, Ww, Ww, Ww, Ww, Ds, Isa, Isa, Isa, Isa, Isa, Ai, Isa, Isa, Ai, Rb, Isa, Isa^Es, Isa, Isa, Isa, Ai, Ai, Ai, Isa, Isa^Ii, Isa, Isa, Isa, Isa, Isa, Isa^Edt, Qxua, Qxua, Ai, Isa, Isa, Isa, Isa
Wo, Wo, Wo, Wo, Wo, Wo, Wo, Ww, Ww, Ww, Ww, Ds, Ds, Isa, Ds, Isa, Isa, Isa, Isa, Isa^Ii, Rb, Ai^Fetd, Ai, Rb, Rb, Isa, Rb, Isa^Em, Ai, Isa, Isa, Isa, Ai, Isa, Isa^Vd, Isa^Edt, Ai, Isa^Edt, Isa, Ai, Ai, Isa, Isa, Isa
Wo, Wo, Wo, Wo, Wo, Wo, Wo, Ww, Ww, Ww, Ww, Ww, Ww, Ds, Ds, Ds, Ds, Rr, Ds, Rr^Em, Rr^Em, Rb, Rb, Rb, Rb, Rb, Rb, Isa^Em, Ai, Isa, Isa, Isa^Fetd, Isa^Fetd, Ai, Ai, Ai, Ai, Ai, Isa, Isa^Vhc, Ai, Isa, Isa, Isa
Wo, Wo, Wo, Wo, Wo, Wo, Wo, Wo, Wo, Wo, Wo, Ww, Ww, Ww, Ww, Ww, Ww, Ds, Ds, Ds, Rb, Rb, Rb, Rb, Ds, Rb, Rb, Rb, Rb, Isa, Isa^Fetd, Isa^Fetd, Isa^Fetd, Ai, Ai, Isa^Fetd, Isa, Ai, Isa, Isa, Isa, Ai, Ai, Isa
Wo, Wo, Wo, Wo, Wo, Wo, Wo, Wo, Wo, Wo, Wo, Wo, Wo, Ww, Ww, Ww, Ww, Ww, Ww, Ds, Ds, Rb, Ds, Ds, Ww, Ds, Ds, Rb, Rb, Isa^Fetd, Ai, Ai, Ai, Isa^Fetd, Isa^Fetd, Isa^Fetd, Isa^Fetd, Isa, Isa, Isa^Ii, Isa, Isa, Ai, Isa
Wo, Wo, Wo, Wo, Wo, Wo, Wo, Wo, Wo, Wo, Wo, Wo, Wo, Ww, Ww, Ww, Ww, Ww, Ww, Ww, Ww, Ds, Ww, Ww, Ww, Ww, Ds, Ds, Rb, Rb^Vh, Ms, Ai, Ms, Ai, Isa, Isa^Fetd, Isa, Isa, Cer, Isa, Isa, Ai, Ms, Ms
Wo, Wo, Wo, Wo, Wo, Wo, Wo, Wo, Wo, Wo, Wo, Wo, Wo, Wo, Wo, Wo, Wo, Wo, Wo, Ww, Ww, Ww, Ww, Ww, Ww, Ww, Ds, Rb, Aa, Aa, Ms, Ms, Ms, Isa, Isa, Isa, Isa, Cer, 4 Ker, Cer^Edt, Ai, Ai, Ms, Ms
Wo, Wo, Wo, Wo, Wo, Wo, Wo, Wo, Wo, Wo, Wo, Wo, Wo, Wo, Wo, Wo, Wo, Ww, Ww, Ww, Ww, Ww, Wo, Wo, Ww, Ww, Ds, Rb, Aa, Aa, Aa, Ms, Ms, Isa, Isa, Isa, Ms, Cer, Cer, Cer, Ai, Ms, Ha^Vo, Ms
Wo, Wo, Wo, Wo, Wo, Wo, Wo, Wo, Wo, Wo, Wo, Wo, Wo, Wo, Wo, Wo, Wo, Ww, Wo, Wo, Wo, Wo, Wo, Wo, Ww, Ww, Ww, Ds, Ds, Aa, Ms, Ms, Ms, Ms, Ms, Isa, Ha^Ve, Ms, Ms, Ai, Ai, Ai^Edt, Ai, Ai
Wo, Wo, Wo, Wo, Wo, Wo, Wo, Wo, Wo, Wo, Wo, Wo, Wo, Wo, Wo, Wo, Wo, Wo, Wo, Wo, Wo, Wo, Wo, Wo, Wo, Ww, Ww, Ds, Ds, Rb, Rb^Es, Ms, Ms, Ms, Aa, Isa, Ms, Ms, Ms, Ai, Ai, Ai, Ai, Ai
Wo, Wo, Wo, Wo, Wo, Wo, Wo, Wo, Wo, Wo, Wo, Wo, Wo, Wo, Wo, Wo, Wo, Wo, Wo, Wo, Wo, Wo, Wo, Wo, Wo, Ww, Ww, Ww, Ww, Ds, Rb, Ms, Aa, Aa, Aa, Aa, Ms, Ms, Ms, Ai, Ai, Ai^Ii, Ai, Ai
Wo, Wo, Wo, Wo, Wo, Wo, Wo, Wo, Wo, Wo, Wo, Wo, Wo, Wo, Wo, Wo, Wo, Wo, Wo, Wo, Wo, Wo, Wo, Wo, Wo, Wo, Ww, Ww, Ww, Ds, Ds, Rb, Ds, Aa, Aa, Aa, Ms, Ms, Ms, Ai, Ai, Ai, Ai, Ai
Wo, Wo, Wo, Wo, Wo, Wo, Wo, Wo, Wo, Wo, Wo, Wo, Wo, Wo, Wo, Wo, Wo, Wo, Wo, Wo, Wo, Wo, Wo, Wo, Wo, Wo, Ww, Ww, Ww, Ds, Ds, Ds, Ds, Ds, Aa, Aa, Ms, Ms, Ms, Ms, Ms, Ms, Ms, Ms
