Isa^Fmw, Isa^Fmw, Isa^Fmw, Isa^Fmw, Isa^Ii, Isa^Ii, Isa^Ii, Isa^Ii, Md, Md, Md, Md, Ai, Isa^Fmw, Isa^Fmw, Isa^Fmw, Isa^Fmw, Isa^Fmw, Isa^Fmw, Isa^Fmw, Isa^Fmw, Isa^Fmw, Isa^Fmw, Isa^Fmw
Isa^Fmw, Isa^Fmw, Isa^Fmw, Isa^Ii, Isa^Fp, Isa^Ii, Isa^Ii, Md, Md, Md, Isa, Ai, Ai, Isa^Fmw, Ai, Ai, Ai, Ai, Ai, Ai, Isa^Fmw, Isa^Fmw, Ai, Isa^Fmw
Isa^Fmw, Isa^Fmw, Isa^Ii, Isa^Ii, Isa, Isa^Fp, Isa^Ii, Md, Isa, Isa, Isa, Ai, Ai, Ai, Ai, Ai, Ai, Ai, Rr^Ii, Ai, Ai, Ai, Rr^Ii, Rr^Ii
Isa^Fmw, Isa^Fmw, Isa^Fmw, Isa, Isa, Isa, Isa, Isa, Isa, Isa, Isa, Isa, Rr^Edt, Rr^Edt, Rr^Edt, Rr^Edt, Rr^Edt, Rr^Edt, Isa, Rr^Ii, Rr^Ii, Ai, Md, Md
Isa^Fmw, Isa^Fmw, Isa^Fmw, Isa, Isa, Isa^Ii, Isa, Isa, Isa^Ii, Isa, Isa, Rr^Edt, Isa^Fdw, Isa^Es, Isa^Fdw, Isa, Isa, Rr^Edt, Rr^Edt, Rr^Edt, Rr^Edt, Md, Md, Md
Isa, Isa^Fmw, Isa, Isa, Isa, Isa, Isa^Ii, Isa^Ii, Isa^Ii, Isa, Isa, Isa^Fdw, Isa^Fdw, Isa^Fdw, Isa^Fdw, Isa^Fdw, Isa^Fdw, Isa, Isa, Ai, Rr^Edt, Md, Md, Md
Isa, Isa, Isa, Isa, Isa, Isa^Ii, Isa^Ii, Isa^Ii, Isa^Ii, Isa, Isa, Isa^Fdw, Isa, Isa, Isa, Isa^Fdw, Isa^Fdw, Isa, Isa, Rr^Edt, Isa, Md, Md, Md
Isa, Isa, Isa, Isa, Ai, Isa, Isa, Isa, Isa^Fdw, Md, Md, Isa, Isa, Isa^Fdw, Isa, Isa, Isa, Isa^Fdw, Rr^Edt, Rr^Edt, Isa, Md, Md, Md
Isa, Isa, Isa^Fdw, Isa, Ai, Isa^Fp, Isa, Isa, Isa^Fp, Isa^Fp, Isa^Fp, Qxua, Isa, Isa, Isa, Isa, Rr^Edt, Rr^Edt, Isa, Isa, Isa, Md, Md, Md
Isa^Fdw, Isa^Fdw, Isa^Fdw, Isa^Fdw, Isa^Fdw, Isa, Isa^Fp, Rr^Edt, Rr^Edt, Isa^Fp, Qxua, Qxua, Rr^Edt, Isa^Edt, Rr^Edt, Rr^Edt, Isa, Isa, Isa, Isa, Isa, Md, Md, Md
Isa^Fdw, Isa^Fdw, Rr, Isa^Fdw, Rr^Ii, Isa^Ii, Isa^Fp, Isa^Fp, Isa^Fp, Rr^Edt, Rr^Edt, Rr^Edt, Rr^Edt, Rr^Edt, Rr^Edt, Isa, Rb, Rb^Em, Isa, Isa, Isa, Isa, Isa, Isa
Isa^Fdw, Rr, Rr, Isa^Ii, Rr, Isa^Ii, Isa^Ii, Isa^Fp, Isa^Fp, Rr^Edt, Isa^Fmw, Rr^Edt, Rr^Edt, Rr^Edt, Isa, Isa, Rb, Rb, Rr^Ii, Isa, Rb^Ii, Isa, Isa, Isa
Isa^Fdw, Rr, Rr, Rr^Ii, Isa, Isa, Isa^Ii, Isa^Fdw, Isa^Fp, Isa^Fmw, Isa, Isa^Fmw, Rr^Edt, Isa^Ve, Isa, Isa, Rb^Edt, Rr, Rb, Rb^Edt, Rb, Rb^Ii, Rb, Isa
Isa^Fdw, Rr, Md, Rr, Isa, Isa, Isa^Ii, Isa^Ii, Isa^Ii, Isa^Ii, Isa^Ii, Isa^Fmw, Rr^Edt, Isa, Rb, Rb^Edt, Isa, Rr, Isa^Edt, Md, Rb, Rb^Edt, Rb, Isa^Fp
Md, Md, Md, Md, Isa, Isa, Isa^Fp, Isa^Fp, Isa, Isa^Es, Isa^Ii, Rr^Edt, Rr^Edt, Isa^Edt, Rb, Rb^Edt, Isa^Edt, Isa^Edt, Md, Isa^Edt, Md, Isa^Fp, Isa^Fp, Isa^Fp
Rb, Md, Md, Md, Md, Isa, Isa^Fp, Isa^Fp, Isa, Isa, Isa^Ii, Isa^Es, Isa^Ii, Isa^Edt, Rb, Rr, Isa^Edt, Isa^Edt, Isa^Edt, Isa^Edt, Isa^Fp, Isa, Rb, Rb
Rb, Rb, Rr, Rr, Rb, Md, Md, Md, Md, Isa, Rr^Ii, Isa^Ii, Isa^Edt, Isa, Isa^Ii, Isa^Ii, Isa^Edt, Isa^Edt, Isa^Edt, Isa^Edt, Isa^Fp, Isa^Fp, Rb, Rb
Rb, Rr, Rb, Rb, Isa, Rb, Md, Md, Md, Md, Rr, Isa, Isa^Fp, Isa, Rr^Ii, Isa^Ii, Isa^Fmw, Isa^Fdw, Isa^Fmw, Isa^Edt, Isa^Fp, Rb, Rb, Rb
Rb, Md, Md, Rb, Rb, Isa, Rb, Md, Rb, Md, Rr, Isa, Rr, Rr^Ii, Isa^Ve, Isa^Fmw, Isa^Fmw, Isa^Fmw, Md, Md, Rb, Rb, Rb, Rb
Rb, Md, Rb, Rb, Isa, Isa, Rb^Ii, Rb^Ii, Rb^Ii, Md, Md, Rr, Rr, Isa^Ii, Isa^Fmw, Isa^Fmw, Isa^Fmw, Isa^Fmw, Md, Isa^Fdw, Rb, Isa, Isa, Rb
Rb, Rb, Isa, Isa, Rb, Rb, Rb, Rb, Rb, Rb, Rr, Rr, Isa, Isa, Isa, Isa^Fmw, Isa^Fmw, Isa, Isa, Md, Md, Isa, Isa, Isa
Rb, Isa, Isa, Isa^Edt, Isa^Edt, Isa, Isa, Isa^Edt, Rb^Edt, Rb, Rr, Isa^Fma, Isa^Fma, Isa^Fma, Isa^Fma, Isa, Isa, Isa, Md, Md, Isa, Isa, Isa, Isa
Rb, Isa, Isa, Isa^Edt, Isa^Edt, Isa^Edt, Isa^Edt, Isa^Edt, Isa, Isa^Edt, Isa, Isa^Fma, Isa, Isa, Isa, Isa, Md, Md, Md, Md, Md, Isa, Isa, Isa
Isa, Rb, Rb, Isa, Isa^Edt, Isa^Edt, Isa^Edt, Isa^Edt, Isa, Isa, Isa^Fdw, Isa, Isa^Fdw, Isa, Isa, Md, Isa^Fds, Md, Md, Md, Md, Md, Md, Isa
Isa, Isa, Rb, Isa, Isa, Isa^Edt, Isa, Isa, Isa, Isa^Ve, Isa^Fdw, Isa^Fdw, Isa, Isa, Isa, Md, Md, Md, Md, Md, Md, Md, Md, Isa
Isa^Fdw, Isa^Fdw, Rb^Edt, Isa^Fdw, Rb, Isa, Isa, Isa, Isa, Isa^Fdw, Isa^Fdw, Isa, Isa, Isa, Isa, Isa, Md, Md, Md, Md, Md, Md, Isa, Isa
Isa^Fdw, Isa^Fdw, Rb, Rb^Edt, Rb^Edt, Isa, Qxua, Isa, Isa^Em, Isa^Fdw, Isa, Isa, Rb^Edt, Isa^Edt, Isa, Isa^Fds, Md, Md, Md, Isa, Isa^Fp, Isa, Isa, Isa
Isa^Fdw, Isa^Fdw, Rb, Rb^Edt, Rb, Rb^Edt, Rb, Rb, Rb^Edt, Isa^Fdw, Rb^Edt, Rb^Edt, Rb^Edt, Rb, Md, Md, Md, Md, Isa, Isa^Fp, Isa^Fp, Isa, Isa, Isa
Isa^Fdw, Isa^Fdw, Isa^Fdw, Rb, Isa, Rb^Edt, Rb^Edt, Rb^Edt, Rb, Rb^Edt, Rb^Edt, Rb^Edt, Isa^Fp, Rb, Rd^Fp, Isa, Isa^Fp, Isa^Fp, Isa, Ai, Isa^Fp, Isa, Hh, Ms
Isa, Isa, Isa, Isa, Isa, Isa^Edt, Rb^Edt, Rb, Ai, Ai, Rb, Isa, Isa^Fp, Isa, Rd^Fp, Isa, Isa^Fp, Isa^Fp, Ai, Ai, Ai, Hh, Md, Ms
Isa, Isa, Isa, Isa^Fp, Isa^Fp, Isa, Isa^Edt, Rb, Rb^Edt, Ai, Ai, Rb, Ai, Ai, Ai, Ai, Ai, Ai, Rd^Fp, Ai, Hh, Md, Md, Md
Isa, Isa, Isa^Fp, Isa^Fp, Isa^Fp, Isa^Fdw, Isa, Isa^Edt, Isa^Edt, Rb^Edt, Rb, Ai, Isa, Ai, Ai, Ai, Ai, Ai, Rd^Fp, Isa^Fp, Isa^Fp, Ms, Ms, Ms
Isa, Isa, Isa, Isa^Fp, Isa, Isa^Fp, Isa^Fdw, Isa^Fdw, Isa^Ve, Rb^Edt, Rra, Isa^Ii, Ms, Isa, Isa, Ai, Isa^Ii, Ai, Isa, Isa, Isa^Ii, Isa, Hh, Ha
Isa^Fdw, Isa, Isa, Isa^Fp, Isa^Fp, Isa^Fp, Isa^Fdw, Isa^Fdw, Isa^Fdw, Isa^Fp, Rra, Ms, Ms, Ms, Ai, Ai, Isa^Fmw, Isa^Fmw, Isa, Isa, Isa^Es, Isa, Isa^Fma, Ai
Isa^Fdw, Isa, Isa, Isa, Isa, Isa, Rb, Isa^Fdw, Isa^Ii, Rra, Isa^Ii, Ms, Ms, Ai, Ms, Ai, Ai, Isa^Fmw, Isa^Fmw, Isa, Isa, Isa, Isa^Fma, Isa
Rr, Isa^Fdw, Rr, Isa^Fmw, Isa^Fmw, Isa^Edt, Isa^Fdw, Isa^Fdw, Rra, Rra^Ii, Isa^Ii, Isa^Ii, Isa^Ii, Ms, Rra^Es, Ai, Rra^Es, Ai, Ai, Isa^Fmw, Isa, Isa^Fma, Isa^Fma, Isa
Isa^Fdw, Rr, Isa^Fmw, Isa^Fmw, Isa^Fmw, Rra, Isa^Fdw, Rra, Rb, Isa, Isa^Fp, Isa^Ii, Isa, Isa^Ii, Rra^Es, Rra^Es, Rra^Es, Ai, Ai, Ai, Ai, Isa^Fma, Isa^Fma, Isa
Isa^Fdw, Isa^Fp, Rra, Isa^Fmw, Rra, Isa, Isa, Isa, Rb, Isa^Fp, Isa^Fp, Isa^Fp, Isa, Isa, Isa, Rra^Es, Rra^Es, Ai, Ai, Ai, Ai, Isa^Fma, Isa^Fma, Isa^Fma
Isa^Fp, Isa^Fp, Rra, Rra, Rra, Isa, Rra, Rb, Isa^Fmw, Isa^Fmw, Isa^Fmw, Rb, Isa^Fma, Isa^Ve, Isa, Rra^Es, Rra^Es, Isa^Fds, Rra^Es, Ai, Isa, Isa^Fma, Isa^Ii, Isa
Isa^Fp, Isa^Em, Rra, Rra^Edt, Rra, Rra, Rra, Rra, Ai, Isa^Fmw, Rb^Em, Isa^Fma, Isa^Fma, Isa, Isa, Isa, Rra^Es, Isa^Fds, Rra^Es, Rra^Es, Isa, Isa, Isa, Isa^Ii
Rra, Rra, Rra^Edt, Rra^Edt, Rra, Rra, Ms, Rra, Rra, Rra, Rb^Em, Isa^Fma, Isa^Fma, Isa^Ii, Isa^Ii, Isa^Ii, Rra^Es, Isa^Fds, Rra^Es, Rra^Es, Rra^Es, Isa, Isa, Isa^Ii
Rra^Edt, Rra^Edt, Isa^Fmw, Rra, Isa^Fmw, Ms, Ms, Rra, Isa^Fp, Isa^Fma, Isa^Fma, Isa^Fma, Isa, Isa^Ii, Isa, Isa^Ii, Rra^Es, Rra^Es, Isa^Fdw, Isa^Fdw, Isa^Fdw, Isa, Isa, Isa
Rra^Edt, Rra^Edt, Rra, Isa^Fmw, Rra, Rra, Ms, Ms, Ms, Ms, Rra^Es, Isa, Isa, Isa, Rd^Fp, Isa, Rra^Es, Rra^Es, Isa^Fdw, Aa^Fpa, Isa^Fdw, Aa, Isa^Edt, Isa^Edt
Isa^Fmw, Rra^Edt, Rra^Edt, Rra, Rra^Edt, Rra^Es, Ms, Ms, Ms, Rra^Es, Rra^Es, Isa, Isa, Isa^Ii, Isa, Isa, Isa, Rra^Es, Aa^Fpa, Isa^Fdw, Aa^Fpa, Aa^Fpa, Isa^Fds, Isa^Edt
Isa^Fmw, Rra, Rra, Rra^Edt, Isa^Edt, Ha^Ii, Ms, Ms, Rra, Rra^Es, Rra^Es, Rra^Es, Rra^Es, Isa, Rra^Es, Rra^Es, Rra^Es, Aa^Fpa, Aa^Fpa, Aa^Fpa, Aa^Fpa, Isa^Fds, Isa, Isa
Isa^Fmw, Isa^Fmw, Isa^Fmw, Rra, Isa^Fmw, Isa^Fp, Ha^Ii, Ms, Ms, Rr, Rr, Isa, Rra^Es, Rra^Es, Isa, Isa, Isa, Isa, Aa^Fpa, Aa^Fpa, Aa^Fpa, Aa^Fpa, Isa, Isa
Isa^Fmw, Isa^Fmw, Isa^Fpa, Isa^Fmw, Isa^Fmw, Ha^Ii, Ha^Ii, Ms, Ms, Ms, Ms, Isa^Ve, Rra^Es, Rra, Rra, Isa^Fp, Isa^Fp, Isa, Isa^Edt, Aa^Fpa, Mv, Qxua, Isa, Isa
Isa^Fmw, Isa^Fmw, Isa^Fpa, Isa^Fpa, Isa^Fpa, Isa^Fmw, Isa^Fmw, Ha^Ii, Ha^Ii, Ha^Ii, Ha^Ii, Ha^Ii, Isa, Isa, Rra, Isa^Fp, Isa, Isa, Isa, Isa, Qxua, Qxua, Isa^Edt, Isa
Isa^Fmw, Isa^Fmw, Isa^Fmw, Isa^Fpa, Isa^Fmw, Isa^Fmw, Isa^Fmw, Isa^Fmw, Ha^Ii, Ha^Ii, Isa^Fmw, Ha^Ii, Isa^Fmw, Md, Isa, Rra, Rra^Ii, Isa, Isa, Rra, Rra, Isa, Isa, Isa
Ai, Aa, Isa^Fmw, Isa^Fmw, Ai, Ai, Ai, Isa^Fmw, Isa, Isa^Fmw, Isa^Fmw, Isa^Fmw, Isa^Fmw, Isa^Fmw, Rra, Rra, Ce, Isa, Rra, Rra, Isa, Isa, Isa^Edt, Isa^Edt
Ai, Ai, Ai, Ai, Ms, Ai, Ai, Isa^Fmw, Isa^Fmw, Isa^Fmw, Aa, Rra, Rra, Rra, Rra^Edt, Ce, 1 Ke, Ce, Isa^Edt, Isa, Isa^Edt, Isa^Edt, Isa, Isa
Ai, Ai, Rra, Rra, Isa, Rra, Rra^Es, Ai, Isa^Fmw, Isa^Fmw, Rra, Rra, Rra, Rra^Edt, Rra^Edt, Ce, Cea, Cea, Isa, Isa, Isa^Edt, Isa, Isa, Isa
Rra, Rra, Isa, Isa, Isa, Isa, Rra, Isa, Isa^Fmw, Isa^Fmw, Isa^Fmw, Isa^Fmw, Rra, Rra^Edt, Rra, Rra, Rra, Isa^Edt, Isa, Isa^Edt, Isa^Edt, Isa^Edt, Isa, Isa
Isa, Ai, Ha, Ha, Ai, Isa, Ai, Isa^Fmw, Isa^Fmw, Isa^Fmw, Isa^Fmw, Rra, Rra, Rra, Isa, Isa, Rra^Ii, Ai, Isa, Isa, Isa^Edt, Isa^Edt, Md, Isa
Ai, Ha, Ha, Ai, Isa, Ai, Isa, Isa, Rb, Rb, Isa, Isa, Rra, Isa, Isa, Isa, Ha, Ai, Isa, Isa, Isa, Isa^Edt, Isa, Isa^Edt
Isa, Isa, Ha, Ha, Ha, Isa, Isa, Rr, Isa, Rra, Rra, Rra, Rra^Edt, Isa, Isa, Isa, Ha, Ai, Ai, Ai, Isa, Isa^Edt, Isa^Edt, Isa^Edt
Isa, Isa, Isa, Isa, Isa, Isa, Rr^Ii, Rr^Ii, Rb, Rb, Rra, Rra, Isa^Edt, Isa, Rb, Rb, Ha, Ai, Ai, Ai, Ai, Ai, Isa^Edt, Isa^Edt
