Ms, Ms, Ms, Ms, Ms, Ms, Ms, Ms, Ms, Ms, Ms, Ms, Ms, Ms, Ms, Ms, Ms, Ms, Ms, Ms, Ms, Ms, Ha, Aa, Aa, Ai, Ai, Ai, Ai, Ai, Ai, Rb, Rb, Isa, Isa, Aa, Aa, Aa, Aa, Aa, Ai, Aa, Aa, Aa
Ms, Ms, Ms, Ms, Ms, Ms^Xm, Ms^Xm, Ms, Ms, Ms, Ms, Ms, Ms, Ms, Ms, Ms, Ms, Ms, Ms, Ms, Ms, Ms, Ha, Ha, Aa, Ai, Aa, Aa, Ai, Ai, Rb, Rb, Isa, Isa, Rra, Aa, Ai, Aa, Ai, Ai, Isa, Ai, Ai, Ai
Ms, Ms, Ms^Xm, Ms, Ms^Xm, Ms, Ms, Ms^Xm, Ms, Ms, Ms^Xm, Ms, Ms, Ms, Ms, Ms, Ms^Xm, Ms^Xm, Ms^Xm, Ms, Ha, Ha, Aa, Aa, Aa, Ai, Ai, Ai, Ai, Ai, Rb, Isa, Isa, Isa, Rra, Aa, Rra, Ai, Ai, Isa, Isa, Isa, Isa, Rra
Ms, Ms, Ms^Xm, Ms^Xm, Ms^Xm, Mm^Xm, Ms^Xm, Ms, Ms, Ms, Ms, Ms, Aa, Ms, Aa, Ms, Ms, Ms, Aa^Em, Ms, Aa, Ha, Ai, Ai, Ai, Ai, Aa, Aa, Aa, Ai, Isa, Isa, Isa, Isa, Isa, Rra, Isa, Rra, Ai, Isa, Isa^Vh, Isa, Rra, Rra
Ms^Xm, Ms^Xm, Mm^Xm, Mm^Xm, Ms^Xm, Ms^Xm, Ms, Ms^Xm, Ms, Ms, Ms, Ha, Ha, Aa, Aa, Aa, Aa^Em, Aa^Em, Aa, Aa, Isa^Fetd, Ai, Ai, Aa, Aa, Aa, Rra, Rra, Aa, Ai, Rra, Isa^Vhr, Isa^Fetd, Isa^Fetd, Isa^Fetd, Isa, Ai, Ai, Isa, Isa, Ce, Isa, Rra, Rra
Ms^Xm, Mm^Xm, Ms^Xm, Ms^Xm, Aa^Fetd, Aa^Fetd, Aa^Fetd, Ms, Aa^Fetd, Ms, Ha, Ha, Isa^Fetd, Rb, Rb, Rb, Rb, Aa, Isa^Fetd, Isa^Fetd, Isa^Fetd, Ai, Isa^Fetd, Aa, Rb, Aa, Rra, Rra, Aa, Ai, Ai, Rra^Fetd, Isa, Isa^Ii, Isa^Fetd, Isa^Fetd, Ai, Isa^Ve, Isa, Ce, 1 Ke, Ce, Rra, Rra
Ms^Xm, Ms^Xm, Ms^Xm, Ha, Ai, Ai, Ai, Aa^Fetd, Aa^Dr, Aa^Fetd, Ha, Ha, Rr^Ii, Rr^Ii, Rr^Ii, Rr^Ii, Rr^Ii, Rb^Esa, Rb, Isa, Isa^Fetd, Ai, Isa^Fetd, Isa^Fetd, Isa^Fetd, Isa^Fetd, Rb, Rra, Rra, Aa, Ai, Rra, Isa^Fetd, Isa^Fetd, Isa, Isa^Fetd, Isa^Fetd, Isa, Isa^Fetd, Ce, Ce, Ce, Rra, Rra
Ms^Xm, Ms^Xm, Ha, Ha, Ai, Ai, Isa^Ii, Isa^Ii, Isa^Ii, Isa^Ii, Ha, Rr^Ii, Isa^Vhr, Isa, Xu^Efs, Rr^Ii, Xu^Efs, Rr^Esa, Rr, Isa, Rr, Isa^Fetd, Isa^Voa, Isa, Isa, Isa, Rb, Rra, Rra, Aa, Ha, Rra, Rra^Fetd, Isa, Isa^Fetd, Isa^Fetd, Isa^Fetd, Isa^Fetd, Isa, Isa, Isa^Edb, Isa, Rra^Vla, Rra
Ms^Xm, Ms^Xm, Ha, Ha, Ai, Isa^Esa, Isa^Esa, Isa^Esa, Isa, Isa, Isa, Isa, Xu^Efs, Xu^Efs, Qxua, Xu^Efs, Qxua, Xu^Efs, Xu^Efs, Xu^Efs, Xu^Efs, Rr^Edb, Rr^Edb, Rr, Cer^Edb, Isa, Rb, Aa, Rra^Es, Rra, Ha, Isa, Isa, Isa, Isa^Fetd, Isa^Fetd, Isa, Isa, Rra, Rra, Rb^Edb, Isa, Rb, Rra
Ha, Ha, Ha, Aa, Ai, Isa, Isa, Isa^Voa, Isa, Isa, Xu^Efs, Xu^Efs, Qxua, Qxua, Qxua, Qxua, Isa^Fetd, Qxua, Qxua, Qxua, Qxua, Xu^Efs, Xu^Efs, Cer^Edb, 3 Ker, Cer^Edb, Rb, Aa^Vla, Aa, Rra^Es, Isa^Esa, Isa, Isa, Isa, Rb^Ii, Isa, Rra, Rra, Rb^Ii, Rb^Ii, Ai, Rb^Edb, Isa^Edb, Rra
Aa, Ha, Ha, Ai, Aa^Voa, Isa, Cer^Edb, Isa, Isa, Xu^Efs, Qxua, Qxua, Qxua, Qxua, Isa^Ecf, Isa^Ecf, Isa^Fetd, Isa^Fetd, Isa^Fetd, Isa^Fetd, Rb^Fetd, Qxua, Xu^Efs, Cer^Edb, Cer^Edb, Cer^Edb, Rra, Ai, Ai, Ai, Ai, Isa^Esa, Ai, Isa, Isa^Edb, Rb^Ii, Rb^Ii, Rb^Ii, Ai, Ai, Ai, Rb, Isa, Isa^Edb
Ai, Ai, Ai, Ai, Aa, Cer, 5 Ker^Edb, Cer^Edb, Isa^Ii, Xu^Efs, Qxua, Qxua, Isa, Isa^Ecf, Isa, Isa, Isa^Edb, Isa^Fetd, Isa^Fetd, Isa^Fetd, Rb^Fetd, Qxua, Qxua, Xu^Efs, Xu^Efs, Xu^Efs, Xu^Efs, Rra^Voa, Rra, Aa, Isa, Isa^Esa, Isa^Esa, Ai, Isa^Edb, Ai, Ai, Ai, Ai, Ai, Isa, Isa, Isa, Isa
Ai, Ai, Ai, Ai, Aa, Cer, Cer^Edb, Cer^Edb, Isa^Ii, Xu^Efs, Qxua, Rb^Fetd, Re^Edb, Isa^Edb, Isa^Edb, Isa^Vu, Xu, Isa^Edb, Isa^Edb, Rb^Fetd, Qxua, Qxua, Rb^Fetd, Qxua, Qxua, Qxua, Qxua, Xu^Efs, Rra^Es, Rra^Es, Isa, Isa^Esa, Isa^Edb, Isa^Edb, Ai, Ai, Aa, Ai, Isa^Vhr, Isa, Isa, Rra, Rra, Isa
Ai, Ha, Ai, Ai, Isa, Aa^Edb, Isa^Ii, Isa^Ii, Xu^Efs, Xu^Efs, Qxua, Re, Re^Vu, Isa^Edb, Xu, Xu, Uu^_s, Xu, Xu, Rb^Fetd, Isa^Edb, Rb^Fetd, Isa^Edb, Rb^Fetd, Rb^Fetd, Rb^Fetd, Qxua, Xu^Efs, Rra, Isa^Ii, Isa, Isa, Isa^Edb, Isa^Vhr, Ai, Ai, Ai, Ai, Ai, Isa, Isa, Isa, Rra, Isa
Ai, Rra, Isa, Isa^Ii, Isa^Voa, Isa^Ii, Xu^Efs, Xu^Efs, Qxua, Qxua, Chr, Rb, Re^Edb, Isa, Xu, Uu^_s, Uu^_s, Uu^_s, Xu, Isa^Edb, Rb^Edb, Isa^Edb, Isa, Qxua, Qxua, Qxua, Xu^Efs, Xu^Efs, Rra, Isa^Ii, Isa^Edb, Isa^Ii, Isa, Ai, Ai, Isa, Isa, Rb, Rb, Rb, Isa, Isa, Isa, Rra
Rb, Rra, Rra, Isa^Ii, Isa, Xu^Efs, Qxua, Qxua, Rb^Fetd, Chr, 2 Khr, Chr, Isa, Isa, Xu, Uu^_s, Uu^_s, Uu^Xo, Uu^Ii, Rb^Edb, Isa^Vu, Rb, Rb^Ecf, Rb^Ecf, Qxua, Xu^Efs, Rra, Rra, Isa^Ii, Isa^Ii, Isa, Isa, Isa, Ai, Isa, Isa, Isa, Isa, Isa, Rra, Isa, Isa, Isa, Isa
Ai, Rb, Rra, Ai, Ai, Xu^Efs, Qxua, Rb^Fetd, Rb^Fetd, Chr, Chr, Chr, Isa^Fetd, Isa^Vu, Isa, Xu, Xu, Xu, Isa, Isa, Isa^Edb, Rb, Qxua, Qxua, Xu^Efs, Xu^Efs, Isa, Isa^Ii, Isa, Isa, Aa, Aa, Isa, Ai, Rb^Ii, Isa, Isa, Rr^Fetd, Rr^Fetd, Isa, Isa^Fetd, Isa^Fetd, Isa^Fetd, Isa
Rb^Fetd, Rb^Fetd, Rb^Fetd, Rra, Rra, Xu^Efs, Xu^Efs, Qxua, Qxua, Rb^Fetd, Rb^Edb, Rb^Edb, Rb^Fetd, Isa^Fetd, Isa^Edb, Isa, Rb^Fetd, Isa, Rb^Fetd, Isa^Edb, Isa, Isa^Edb, Ai, Xu^Efs, Ai, Isa, Ai, Isa, Isa, Isa, Aa, Aa, Isa, Rb^Ii, Ha, Rb^Ii, Ha, Rr^Fetd, Rr^Esa, Rr^Esa, Rr^Esa, Rr^Esa, Rr^Fetd, Rr^Fetd
Ai, Ai, Ai, Rb^Fetd, Ai, Rra, Rra, Xu^Efs, Xu^Efs, Qxua, Qxua, Rb^Vu, Isa^Ecf, Isa^Edb, Rb^Fetd, Rb^Fetd, Rb^Fetd, Rb^Fetd, Qxua, Qxua, Isa, Ai, Isa^Edb, Ai, Cer, Ai, Isa^Edb, Isa^Voa, Rb^Ii, Isa, Aa^Fetd, Aa^Fetd, Rb^Ii, Rb^Ii, Ha, Ha, Rra, Rr, Rra^Edb, Rr^Edb, Rr, Rr^Edb, Aa, Aa
Ai, Ai, Ai, Rb^Fetd, Ai, Ai, Rra, Rra, Rra^Fetd, Xu^Efs, Xu^Efs, Qxua, Qxua, Isa^Ecf, Qxua, Qxua, Qxua, Qxua, Xu^Efs, Xu^Efs, Isa^Voa, Isa^Edb, Isa, Cer^Edb, 4 Ker, Cer^Edb, Isa^Edb, Rb^Ii, Ai^Edb, Rb^Ii, Aa^Fetd, Ha, Ha, Ha, Ha, Rb, Rb, Rra, Ha, Rra, Aa, Aa^Dr, Aa, Aa
Ai, Ai, Ai, Ai, Ai, Ai, Ai, Rra^Fetd, Rra, Rra^Fetd, Xu^Efs, Qxua, Qxua, Qxua, Xu^Efs, Xu^Efs, Xu^Efs, Xu^Efs, Ha, Isa, Isa, Isa, Rr^Fetd, Cer^Edb, Cer^Edb, Cer^Edb, Rb^Edb, Rb^Edb, Ai, Rb^Ii, Aa^Fetd, Ha, Ha, Ha, Ms, Ha, Ha, Ha, Ha, Aa, Aa, Aa, Ms, Ms
Ai, Ai, Ai, Ai, Ai, Ai, Ai, Ai, Rra, Rra, Rra, Xu^Efs, Xu^Efs, Xu^Efs, Isa, Ai, Isa, Ha, Ai, Ha, Rr^Fetd, Rr^Fetd, Ha, Ha, Ha^Voa, Ha^Edb, Ha, Ai, Ai, Aa, Ha, Ha, Ha, Ha, Ms, Ms, Ms, Ha, Ms, Ms, Aa, Aa, Ms, Ms
Aa^Ii, Ai, Ai, Ai, Ai, Ai, Rra, Rra, Ai, Ai, Rr^Fetd, Rra, Rra^Edb, Isa^Edb, Isa^Edb, Ai, Ai, Isa^Ii, Isa, Ai, Ha, Rr^Fetd, Ha, Ha, Ha, Ha, Ha, Ai, Ha, Aa, Aa, Ha, Ms^Xm, Ms, Ms^Xm, Ms, Ms, Ms, Ms, Ms, Ms, Ms, Ms^Xm, Ms
Aa^Ii, Ai, Ai, Ai, Ai, Rra^Esa, Rra, Aa, Ai, Rr^Fetd, Isa^Edb, Rra^Edb, Isa, Isa, Isa, Ai, Ai, Isa, Isa^Vhhr, Ai, Ai, Ha, Aa, Ha, Ha, Ha, Aa, Ha, Aa, Aa, Aa, Ms, Ms, Ms, Ms^Xm, Ms, Ms^Xm, Ms, Ms, Ms, Ms, Ms, Ms, Ms
Aa^Ii, Aa^Ii, Ai, Ai, Rra, Rra, Aa, Aa, Isa, Rr^Fetd, Isa, Isa, Isa^Es, Isa, Isa, Rra, Isa, Isa, Rr^Ii, Rr^Ii, Aa, Aa, Aa, Ha, Ha, Aa, Aa, Aa, Aa, Aa^Em, Ms, Ms, Ms, Ms^Xm, Ms^Xm, Ms^Xm, Ms^Xm, Ms, Ms^Xm, Ms, Ms, Ms, Ms, Ms
Ai, Ai, Ai, Rra, Isa, Aa^Edb, Isa^Edb, Aa, Isa, Isa, Isa^Esa, Isa^Esa, Isa, Isa, Isa, Isa, Rr^Ii, Rr^Ii, Aa, Aa, Ai, Aa, Ai, Aa, Aa, Aa, Ms^Xm, Ms^Xm, Ms^Xm, Ms^Xm, Mm^Xm, Ms^Xm, Ms^Xm, Ms^Xm, Ms^Xm, Ms^Xm, Ms^Xm, Ms^Xm, Ms, Ms, Ms^Xm, Ms^Xm, Ms, Ms
Isa^Ii, Isa^Ii, Rra, Rra, Isa^Fetd, Isa, Isa, Isa^Edb, Isa, Isa^Esa, Isa, Isa, Isa, Isa, Rr^Ii, Rr^Ii, Ai, Aa, Ai, Aa, Ai, Ai, Aa, Aa, Ms^Xm, Ms^Xm, Ms^Xm, Ms^Xm, Ms^Xm, Ms^Xm, Ms^Xm, Ms^Xm, Ms, Ms^Xm, Ms^Xm, Ms^Xm, Ms^Xm, Ms, Ms, Ms^Xm, Ms, Ms, Ms, Ms
Isa, Isa, Isa, Isa, Isa^Fetd, Isa^Fetd, Isa^Fetd, Isa^Ii, Isa, Isa, Isa, Isa, Rr^Ii, Rr^Ii, Isa, Ai, Ai, Ai, Ai, Ai, Aa, Aa, Aa, Aa, Ms^Xm, Ms^Xm, Ms^Xm, Ms^Xm, Ms^Xm, Ms^Xm, Ms^Xm, Ms^Xm, Ms^Xm, Ms^Xm, Ms^Xm, Ms^Xm, Ms^Xm, Ms, Ms, Ms, Ms, Ms, Ms, Ms
