Xu^Efs, Xu^Efs, Xu^Efs, Xu^Efs, Xu^Efs, Xu^Efs, Xu^Efs, Xu^Efs, Xu^Efs, Xu^Efs, Xu^Efs, Xu^Efs, Xu^Efs, Xu^Efs, Xu^Efs, Xu^Efs, Xu^Efs, Xu^Efs, Xu^Efs, Xu^Efs, Xu^Efs, Xu^Efs, Xu^Efs, Xu^Efs, Xu^Efs, Xu^Efs, Xu^Efs, Xu^Efs, Xu^Efs, Xu^Efs, Xu^Efs, Xu^Efs, Xu^Efs, Xu^Efs, Xu^Efs, Uu^Edb, Ur^Edb, Urb^Edb, Xu^Efs, Xu^Efs, Xu^Efs, Xu^Efs, Xu^Efs, Xu^Efs, Xu^Efs, Xu^Efs
Xu^Efs, Xu^Efs, Xu^Efs, Xu^Efs, Xu^Efs, Xu^Efs, Xu^Efs, Xu^Efs, Xu^Efs, Xu^Efs, Xu^Efs, Xu^Efs, Xu^Efs, Xu^Efs, Xu^Efs, Xu^Efs, Xu^Efs, Xu^Efs, Xu^Efs, Xu^Efs, Xu^Efs, Xu^Efs, Xu^Efs, Xu^Efs, Xu^Efs, Xu^Efs, Xu^Efs, Xu^Efs, Xu^Efs, Xu^Efs, Xu^Efs, Xu^Efs, Xu^Efs, Xu^Efs, Xu^Efs, Uu^Edb, Ce, Urb^Edb, Xu^Efs, Xu^Efs, Xu^Efs, Xu^Efs, Xu^Efs, Xu^Efs, Xu^Efs, Xu^Efs
Xu^Efs, Xu^Efs, Xu^Efs, Xu^Efs, Xu^Efs, Xu^Efs, Xu^Efs, Xu^Efs, Xu^Efs, Xu^Efs, Xu^Efs, Xu^Efs, Xu^Efs, Xu^Efs, Xu^Efs, Xu^Efs, Xu^Efs, Xu^Efs, Xu^Efs, Xu^Efs, Xu^Efs, Xu^Efs, Xu^Efs, Xu^Efs, Xu^Efs, Xu^Efs, Xu^Efs, Xu^Efs, Xu^Efs, Xu^Efs, Xu^Efs, Xu^Efs, Xu^Efs, Xu^Efs, Xu^Efs, Ce, 1 Ke, Ce, Xu^Efs, Xu^Efs, Xu^Efs, Xu^Efs, Xu^Efs, Xu^Efs, Xu^Efs, Xu^Efs
Xu^Efs, Xu^Efs, Xu^Efs, Xu^Efs, Xu^Efs, Xu^Efs, Xu^Efs, Xu^Efs, Xu^Efs, Xu^Efs, Xu^Efs, Xu^Efs, Xu^Efs, Xu^Efs, Xu^Efs, Xu^Efs, Xu^Efs, Xu^Efs, Xu^Efs, Xu^Efs, Xu^Efs, Xu^Efs, Xu^Efs, Xu^Efs, Xu^Efs, Xu^Efs, Xu^Efs, Xu^Efs, Xu^Efs, Xu^Efs, Xu^Efs, Xu^Efs, Xu^Efs, Xu^Efs, Xu^Efs, Ce, Ce^Edb, Ce, Xu^Efs, Xu^Efs, Xu^Efs, Xu^Efs, Xu^Efs, Xu^Efs, Xu^Efs, Xu^Efs
Xu^Efs, Xu^Efs, Xu^Efs, Xu^Efs, Xu^Efs, Xu^Efs, Xu^Efs, Xu^Efs, Xu^Efs, Xu^Efs, Xu^Efs, Xu^Efs, Xu^Efs, Xu^Efs, Xu^Efs, Xu^Efs, Xu^Efs, Xu^Efs, Ur, Xu^Efs, Xu^Efs, Xu^Efs, Xu^Efs, Xu^Efs, Xu^Efs, Xu^Efs, Xu^Efs, Xu^Efs, Xu^Efs, Xu^Efs, Xu^Efs, Xu^Efs, Xu^Efs, Xu^Efs, Xu^Efs, Uu^Ii, Ur, Urb^Edb, Xu^Efs, Xu^Efs, Xu^Efs, Xu^Efs, Xu^Efs, Xu^Efs, Xu^Efs, Xu^Efs
Xu^Efs, Xu^Efs, Xu^Efs, Xu^Efs, Xu^Efs, Xu^Efs, Xu^Efs, Xu^Efs, Xu^Efs, Xu^Efs, Xu^Efs, Xu^Efs, Xu^Efs, Xu^Efs, Xu^Efs, Xu^Efs, Ur, Ur, Urb^Edb, Urb^Edb, Urb^Edb, Urb^Edb, Urb, Xu^Efs, Xu^Efs, Xu^Efs, Xu^Efs, Xu^Efs, Xu^Efs, Xu^Efs, Xu^Efs, Xu^Efs, Xu^Efs, Xu^Efs, Uu, Uu, Ur, Urb, Xu^Efs, Xu^Efs, Xu^Efs, Xu^Efs, Xu^Efs, Xu^Efs, Xu^Efs, Xu^Efs
Xu^Efs, Xu^Efs, Xu^Efs, Xu^Efs, Xu^Efs, Xu^Efs, Xu^Efs, Xu^Efs, Xu^Efs, Xu^Efs, Xu^Efs, Xu^Efs, Xu^Efs, Xu^Efs, Ur, Ur, Urb^Edb, Ur, Chr^Edb, 4 Khr, Chr^Edb, Urb^Edb, Urb^Edb, Urb^Edb, Urb^Edb, Xu^Efs, Xu^Efs, Xu^Efs, Xu^Efs, Xu^Efs, Xu^Efs, Xu^Efs, Uu^Ii, Uu^Edb, Ur^Ii, Ur, Urb^Edb, Urb^Vu, Xu^Efs, Xu^Efs, Xu^Efs, Xu^Efs, Xu^Efs, Xu^Efs, Xu^Efs, Xu^Efs
Xu^Efs, Xu^Efs, Xu^Efs, Xu^Efs, Xu^Efs, Xu^Efs, Xu^Efs, Xu^Efs, Xu^Efs, Xu^Efs, Xu^Efs, Xu^Efs, Urb^Edb, Urb^Edb, Urb^Edb, Urb^Edb, Uu^Edb, Ur, Ur, Chr^Edb, Ur, Uu, Uu^Edb, Urb^Edb, Urb, Xu^Efs, Xu^Efs, Xu^Efs, Xu^Efs, Xu^Efs, Uu^Ii, Uu^Ii, Ur^Edb, Ur^Ii, Urb^Ii, Urb^Ii, Xu^Efs, Xu^Efs, Xu^Efs, Xu^Efs, Xu^Efs, Xu^Efs, Xu^Efs, Xu^Efs, Xu^Efs, Xu^Efs
Xu^Efs, Xu^Efs, Xu^Efs, Xu^Efs, Xu^Efs, Xu^Efs, Xu^Efs, Xu^Efs, Xu^Efs, Xu^Efs, Xu^Efs, Xu^Efs, Urb^Edb, Urb^Edb, Uu^Edb, Uu^Edb, Ur^Edb, Ur, Urb^Ii, Urb^Ii, Urb^Ii, Ur, Ur^Edb, Uu, Uu, Urb, Urb, Xu^Efs, Uu^Edb, Uu^Ii, Ur^Edb, Ur^Edb, Urb^Edb, Urb^Ii, Xu^Efs, Xu^Efs, Xu^Efs, Xu^Efs, Xu^Efs, Xu^Efs, Xu^Efs, Xu^Efs, Xu^Efs, Xu^Efs, Xu^Efs, Xu^Efs
Xu^Efs, Xu^Efs, Xu^Efs, Xu^Efs, Xu^Efs, Xu^Efs, Xu^Efs, Xu^Efs, Xu^Efs, Xu^Efs, Urb^Edb, Urb^Edb, Uu, Uu, Ur^Edb, Ur^Edb, Urb^Edb, Urb^Ii, Xu^Efs, Xu^Efs, Xu^Efs, Urb^Ii, Urb^Edb, Ur, Ur, Uu, Uu, Uu, Ur, Ur, Urb^Edb, Urb^Edb, Xu^Efs, Xu^Efs, Xu^Efs, Xu^Efs, Xu^Efs, Xu^Efs, Xu^Efs, Xu^Efs, Xu^Efs, Xu^Efs, Xu^Efs, Xu^Efs, Xu^Efs, Xu^Efs
Xu^Efs, Xu^Efs, Xu^Efs, Xu^Efs, Xu^Efs, Xu^Efs, Xu^Efs, Xu^Efs, Urb, Urb, Uu^Vu, Uu, Ur^Ii, Ur, Urb^Edb, Urb^Edb, Xu^Efs, Xu^Efs, Qxua, Qxua, Qxua, Xu^Efs, Xu^Efs, Urb^Edb, Urb^Edb, Ur, Ur, Ur, Urb, Urb, Xu^Efs, Xu^Efs, Xu^Efs, Xu^Efs, Xu^Efs, Xu^Efs, Xu^Efs, Xu^Efs, Xu^Efs, Xu^Efs, Xu^Efs, Xu^Efs, Xu^Efs, Xu^Efs, Xu^Efs, Xu^Efs
Xu^Efs, Xu^Efs, Xu^Efs, Xu^Efs, Xu^Efs, Xu^Efs, Xu^Efs, Xu^Efs, Urb, Urb, Uu, Ur^Ii, Urb, Urb, Xu^Efs, Xu^Efs, Uu^Edb, Qxua, Urb, Qxua^Ii, Qxua, Qxua, Qxua, Xu^Efs, Xu^Efs, Urb, Urb^Vu, Urb, Xu^Efs, Xu^Efs, Xu^Efs, Xu^Efs, Xu^Efs, Xu^Efs, Xu^Efs, Xu^Efs, Xu^Efs, Xu^Efs, Xu^Efs, Xu^Efs, Xu^Efs, Xu^Efs, Xu^Efs, Xu^Efs, Xu^Efs, Xu^Efs
Xu^Efs, Xu^Efs, Xu^Efs, Xu^Efs, Xu^Efs, Xu^Efs, Xu^Efs, Xu^Efs, Urb, Urb, Uu^Ii, Ur^Ii, Urb^Edb, Xu^Efs, Qxua, Qxua, Uu^Edb, Urb, Urb^Edb, Urb^Ii, Qxua, Urb^Ii, Qxua, Qxua, Qxua, Xu^Efs, Xu^Efs, Xu^Efs, Uu^Edb, Xu^Efs, Xu^Efs, Xu^Efs, Xu^Efs, Xu^Efs, Xu^Efs, Xu^Efs, Xu^Efs, Xu^Efs, Xu^Efs, Xu^Efs, Xu^Efs, Xu^Efs, Xu^Efs, Xu^Efs, Xu^Efs, Xu^Efs
Xu^Efs, Xu^Efs, Xu^Efs, Xu^Efs, Xu^Efs, Xu^Efs, Xu^Efs, Xu^Efs, Urb, Urb, Uu^Edb, Ur^Edb, Urb^Edb, Xu^Efs, Qxua, Qxua, Qxua, Uu^Edb, Chr, Urb^Edb, Chr, Qxua, Qxua, Qxua, Qxua, Qxua, Urb^Edb, Ur^Edb, Uu^Edb, Xu^Efs, Xu^Efs, Xu^Efs, Xu^Efs, Xu^Efs, Xu^Efs, Xu^Efs, Xu^Efs, Xu^Efs, Xu^Efs, Xu^Efs, Xu^Efs, Xu^Efs, Xu^Efs, Xu^Efs, Xu^Efs, Xu^Efs
Xu^Efs, Xu^Efs, Xu^Efs, Xu^Efs, Xu^Efs, Xu^Efs, Xu^Efs, Xu^Efs, Urb, Urb, Uu, Ur^Edb, Urb^Ii, Xu^Efs, Qxua, Urb, Qxua, Uu^Edb, Chr, Chr^Edb, Chr^Edb, Urb^Edb, Urb^Ii, Urb^Ii, Urb, Urb^Edb, Urb^Edb, Ur, Uu^Edb, Xu^Efs, Xu^Efs, Xu^Efs, Xu^Efs, Xu^Efs, Xu^Efs, Xu^Efs, Xu^Efs, Xu^Efs, Xu^Efs, Xu^Efs, Xu^Efs, Xu^Efs, Xu^Efs, Xu^Efs, Xu^Efs, Xu^Efs
Xu^Efs, Xu^Efs, Xu^Efs, Xu^Efs, Xu^Efs, Xu^Efs, Xu^Efs, Xu^Efs, Urb, Urb, Uu^Edb, Ur^Edb, Urb^Ii, Xu^Efs, Qxua, Qxua, Qxua, Chr, Chr^Edb, 2 Khr, Chr^Edb, Chr, Urb, Urb, Urb, Urb^Edb, Urb^Ii, Ur, Uu^Ii, Ur, Xu^Efs, Xu^Efs, Xu^Efs, Xu^Efs, Xu^Efs, Xu^Efs, Xu^Efs, Xu^Efs, Xu^Efs, Xu^Efs, Xu^Efs, Xu^Efs, Xu^Efs, Xu^Efs, Xu^Efs, Xu^Efs
Xu^Efs, Xu^Efs, Xu^Efs, Xu^Efs, Xu^Efs, Xu^Efs, Xu^Efs, Xu^Efs, Urb, Urb, Uu^Edb, Ur^Edb, Urb, Xu^Efs, Qxua, Qxua^Ii, Qxua, Urb^Edb, Chr, Chr^Edb, Chr, Urb, Qxua, Urb^Es, Qxua, Urb, Urb, Ur^Ii, Uu^Ii, Ur, Xu^Efs, Xu^Efs, Xu^Efs, Xu^Efs, Xu^Efs, Xu^Efs, Xu^Efs, Xu^Efs, Xu^Efs, Xu^Efs, Xu^Efs, Xu^Efs, Xu^Efs, Xu^Efs, Xu^Efs, Xu^Efs
Xu^Efs, Xu^Efs, Xu^Efs, Xu^Efs, Xu^Efs, Xu^Efs, Xu^Efs, Xu^Efs, Urb, Urb, Uu^Edb, Ur^Edb, Urb, Xu^Efs, Qxua, Uu^Edb, Urb^Edb, Urb, Urb^Edb, Urb^Edb, Urb, Urb, Qxua, Qxua, Xu^Efs, Xu^Efs, Urb, Ur, Chr^Edb, Ur, Urb^Edb, Xu^Efs, Xu^Efs, Xu^Efs, Xu^Efs, Xu^Efs, Xu^Efs, Xu^Efs, Xu^Efs, Xu^Efs, Xu^Efs, Xu^Efs, Xu^Efs, Xu^Efs, Xu^Efs, Xu^Efs
Xu^Efs, Xu^Efs, Xu^Efs, Xu^Efs, Xu^Efs, Xu^Efs, Xu^Efs, Xu^Efs, Urb, Urb, Uu^Vu, Ur, Ur, Urb, Urb, Urb^Edb, Urb^Edb, Urb^Edb, Qxua, Qxua, Qxua, Qxua, Xu^Efs, Xu^Efs, Urb^Edb, Urb, Uu^Edb, Chr^Edb, 5 Khr, Urb^Edb, Urb^Edb, Xu^Efs, Xu^Efs, Xu^Efs, Xu^Efs, Xu^Efs, Xu^Efs, Xu^Efs, Xu^Efs, Xu^Efs, Xu^Efs, Xu^Efs, Xu^Efs, Xu^Efs, Xu^Efs, Xu^Efs
Xu^Efs, Xu^Efs, Xu^Efs, Xu^Efs, Xu^Efs, Xu^Efs, Xu^Efs, Xu^Efs, Xu^Efs, Urb, Urb, Uu, Uu, Ur^Es, Ur, Urb^Ii, Urb, Qxua, Qxua, Qxua, Xu^Efs, Xu^Efs, Urb^Edb, Urb^Edb, Uu^Edb, Uu^Edb, Uu^Edb, Chr^Edb, Urb^Edb, Urb^Edb, Xu^Efs, Xu^Efs, Xu^Efs, Xu^Efs, Xu^Efs, Xu^Efs, Xu^Efs, Xu^Efs, Xu^Efs, Xu^Efs, Xu^Efs, Xu^Efs, Xu^Efs, Xu^Efs, Xu^Efs, Xu^Efs
Xu^Efs, Xu^Efs, Xu^Efs, Xu^Efs, Xu^Efs, Xu^Efs, Xu^Efs, Xu^Efs, Xu^Efs, Xu^Efs, Xu^Efs, Urb, Ur, Uu, Urb, Ur^Ii, Ur, Urb, Xu^Efs, Xu^Efs, Urb^Edb, Urb^Edb, Ur^Edb, Ur^Edb, Uu^Edb, Uu^Edb, Ur, Urb^Edb, Urb^Edb, Urb^Edb, Xu^Efs, Xu^Efs, Xu^Efs, Xu^Efs, Xu^Efs, Xu^Efs, Xu^Efs, Xu^Efs, Xu^Efs, Xu^Efs, Xu^Efs, Xu^Efs, Xu^Efs, Xu^Efs, Xu^Efs, Xu^Efs
Xu^Efs, Xu^Efs, Xu^Efs, Xu^Efs, Xu^Efs, Xu^Efs, Xu^Efs, Xu^Efs, Xu^Efs, Xu^Efs, Xu^Efs, Xu^Efs, Xu^Efs, Ur, Ur, Uu^Vu, Xu^Efs, Xu^Efs, Urb^Ii, Urb^Ii, Ur^Edb, Ur^Edb, Uu, Uu, Uu^Edb, Uu^Edb, Urb, Urb, Xu^Efs, Xu^Efs, Xu^Efs, Xu^Efs, Xu^Efs, Xu^Efs, Xu^Efs, Xu^Efs, Xu^Efs, Xu^Efs, Xu^Efs, Xu^Efs, Xu^Efs, Xu^Efs, Xu^Efs, Xu^Efs, Xu^Efs, Xu^Efs
Xu^Efs, Xu^Efs, Xu^Efs, Xu^Efs, Xu^Efs, Xu^Efs, Xu^Efs, Xu^Efs, Xu^Efs, Xu^Efs, Xu^Efs, Xu^Efs, Xu^Efs, Xu^Efs, Xu^Efs, Xu^Efs, Urb, Urb, Ur^Edb, Ur^Edb, Uu, Uu, Urb, Uu^Edb, Urb, Urb, Xu^Efs, Xu^Efs, Xu^Efs, Xu^Efs, Qxua, Xu^Efs, Xu^Efs, Xu^Efs, Xu^Efs, Xu^Efs, Xu^Efs, Xu^Efs, Xu^Efs, Xu^Efs, Xu^Efs, Xu^Efs, Xu^Efs, Xu^Efs, Xu^Efs, Xu^Efs
Xu^Efs, Xu^Efs, Xu^Efs, Xu^Efs, Xu^Efs, Xu^Efs, Xu^Efs, Xu^Efs, Xu^Efs, Xu^Efs, Xu^Efs, Xu^Efs, Xu^Efs, Xu^Efs, Urb^Vu, Urb, Ur, Ur, Uu, Uu, Urb, Urb, Urb, Urb, Xu^Efs, Xu^Efs, Xu^Efs, Xu^Efs, Qxua, Qxua, Qxua, Qxua, Urb, Xu^Efs, Xu^Efs, Xu^Efs, Xu^Efs, Xu^Efs, Xu^Efs, Xu^Efs, Xu^Efs, Xu^Efs, Xu^Efs, Xu^Efs, Xu^Efs, Xu^Efs
Xu^Efs, Xu^Efs, Xu^Efs, Xu^Efs, Xu^Efs, Xu^Efs, Xu^Efs, Xu^Efs, Xu^Efs, Xu^Efs, Xu^Efs, Xu^Efs, Xu^Efs, Xu^Efs, Xu^Efs, Urb, Urb^Edb, Ur^Edb, Ur^Edb, Uu, Uu^Ii, Xu^Efs, Xu^Efs, Xu^Efs, Xu^Efs, Xu^Efs, Qxua, Urb^Edb, Qxua, Qxua, Qxua, Qxua, Qxua, Urb, Urb, Xu^Efs, Xu^Efs, Xu^Efs, Xu^Efs, Xu^Efs, Xu^Efs, Xu^Efs, Xu^Efs, Xu^Efs, Xu^Efs, Xu^Efs
Xu^Efs, Xu^Efs, Xu^Efs, Xu^Efs, Xu^Efs, Xu^Efs, Xu^Efs, Xu^Efs, Xu^Efs, Xu^Efs, Xu^Efs, Xu^Efs, Xu^Efs, Xu^Efs, Xu^Efs, Xu^Efs, Xu^Efs, Urb^Edb, Urb^Ii, Ur^Ii, Ur^Edb, Uu^Ii, Urb^Ii, Xu^Efs, Qxua, Qxua, Qxua, Urb^Edb, Qxua, Qxua, Qxua^Ii, Qxua, Qxua, Urb, Qxua^Ii, Urb^Ii, Qxua, Xu^Efs, Xu^Efs, Xu^Efs, Xu^Efs, Xu^Efs, Xu^Efs, Xu^Efs, Xu^Efs, Xu^Efs
Xu^Efs, Xu^Efs, Xu^Efs, Xu^Efs, Xu^Efs, Xu^Efs, Xu^Efs, Xu^Efs, Xu^Efs, Xu^Efs, Xu^Efs, Xu^Efs, Xu^Efs, Xu^Efs, Xu^Efs, Xu^Efs, Xu^Efs, Xu^Efs, Xu^Efs, Urb^Edb, Urb^Edb, Urb^Edb, Urb, Urb^Es, Urb, Qxua, Urb^Edb, Urb^Edb, Qxua, Qxua, Qxua^Ii, Qxua, Qxua, Urb, Qxua, Urb^Ii, Qxua, Qxua, Qxua, Xu^Efs, Xu^Efs, Xu^Efs, Xu^Efs, Xu^Efs, Xu^Efs, Xu^Efs
Xu^Efs, Xu^Efs, Xu^Efs, Xu^Efs, Xu^Efs, Xu^Efs, Xu^Efs, Xu^Efs, Xu^Efs, Xu^Efs, Xu^Efs, Xu^Efs, Xu^Efs, Xu^Efs, Xu^Efs, Xu^Efs, Xu^Efs, Xu^Efs, Xu^Efs, Xu^Efs, Urb^Edb, Urb^Edb, Urb^Edb, Urb, Urb^Edb, Urb, Urb^Edb, Qxua, Urb^Ii, Qxua^Ii, Qxua, Qxua, Urb, Urb, Qxua, Qxua, Qxua, Qxua, Qxua, Qxua, Qxua, Xu^Efs, Xu^Efs, Xu^Efs, Xu^Efs, Xu^Efs
Xu^Efs, Xu^Efs, Xu^Efs, Xu^Efs, Xu^Efs, Xu^Efs, Xu^Efs, Xu^Efs, Xu^Efs, Xu^Efs, Xu^Efs, Xu^Efs, Xu^Efs, Xu^Efs, Xu^Efs, Xu^Efs, Xu^Efs, Xu^Efs, Xu^Efs, Xu^Efs, Qxua, Urb, Qxua, Urb^Edb, Qxua, Urb^Edb, Urb, Qxua, Qxua, Qxua, Urb, Urb, Urb^Edb, Urb, Urb^Edb, Qxua, Qxua, Qxua, Qxua, Qxua, Qxua, Xu^Efs, Xu^Efs, Xu^Efs, Xu^Efs, Xu^Efs
Xu^Efs, Xu^Efs, Xu^Efs, Xu^Efs, Xu^Efs, Xu^Efs, Xu^Efs, Xu^Efs, Xu^Efs, Xu^Efs, Xu^Efs, Xu^Efs, Xu^Efs, Xu^Efs, Xu^Efs, Xu^Efs, Xu^Efs, Xu^Efs, Xu^Efs, Xu^Efs, Qxua, Qxua, Qxua, Qxua^Ii, Urb^Ii, Urb^Ii, Urb^Ii, Urb, Urb^Edb, Urb^Edb, Urb, Chr^Edb, Chr^Edb, Chr^Edb, Urb^Edb, Qxua, Qxua, Urb^Ii, Qxua, Qxua, Qxua, Xu^Efs, Xu^Efs, Xu^Efs, Xu^Efs, Xu^Efs
Xu^Efs, Xu^Efs, Xu^Efs, Xu^Efs, Xu^Efs, Xu^Efs, Xu^Efs, Xu^Efs, Xu^Efs, Xu^Efs, Xu^Efs, Xu^Efs, Xu^Efs, Xu^Efs, Xu^Efs, Xu^Efs, Xu^Efs, Xu^Efs, Xu^Efs, Xu^Efs, Qxua, Qxua, Urb, Qxua, Urb, Qxua, Qxua, Qxua, Qxua, Urb^Edb, Chr, Chr^Edb, 3 Khr, Chr^Edb, Chr^Edb, Urb, Urb, Qxua, Urb^Edb, Urb^Edb, Urb^Edb, Xu^Efs, Xu^Efs, Xu^Efs, Xu^Efs, Xu^Efs
Xu^Efs, Xu^Efs, Xu^Efs, Xu^Efs, Xu^Efs, Xu^Efs, Xu^Efs, Xu^Efs, Xu^Efs, Xu^Efs, Xu^Efs, Xu^Efs, Xu^Efs, Xu^Efs, Xu^Efs, Xu^Efs, Xu^Efs, Xu^Efs, Xu^Efs, Xu^Efs, Urb, Qxua, Urb, Urb, Urb, Qxua, Qxua, Qxua, Urb^Ii, Urb, Urb^Edb, Chr^Edb, Chr^Edb, Chr^Edb, Urb, Urb, Urb, Urb^Ii, Urb, Urb, Urb^Edb, Xu^Efs, Xu^Efs, Xu^Efs, Xu^Efs, Xu^Efs
Xu^Efs, Xu^Efs, Xu^Efs, Xu^Efs, Xu^Efs, Xu^Efs, Xu^Efs, Xu^Efs, Xu^Efs, Xu^Efs, Xu^Efs, Xu^Efs, Xu^Efs, Xu^Efs, Xu^Efs, Xu^Efs, Xu^Efs, Xu^Efs, Xu^Efs, Xu^Efs, Qxua^Ii, Urb, Qxua, Urb^Edb, Urb^Edb, Urb, Urb, Qxua^Ii, Urb, Urb^Edb, Qxua, Chr^Edb, Urb^Edb, Chr, Urb, Urb^Es, Qxua, Urb, Qxua, Urb, Qxua, Xu^Efs, Xu^Efs, Xu^Efs, Xu^Efs, Xu^Efs
Xu^Efs, Xu^Efs, Xu^Efs, Xu^Efs, Xu^Efs, Xu^Efs, Xu^Efs, Xu^Efs, Xu^Efs, Xu^Efs, Xu^Efs, Xu^Efs, Xu^Efs, Xu^Efs, Xu^Efs, Xu^Efs, Xu^Efs, Xu^Efs, Xu^Efs, Xu^Efs, Qxua^Ii, Qxua, Qxua, Qxua, Qxua, Urb^Edb, Urb, Urb^Ii, Urb, Urb, Qxua, Qxua, Qxua, Qxua, Urb, Qxua, Qxua, Qxua, Qxua, Qxua, Qxua, Xu^Efs, Xu^Efs, Xu^Efs, Xu^Efs, Xu^Efs
Xu^Efs, Xu^Efs, Xu^Efs, Xu^Efs, Xu^Efs, Xu^Efs, Xu^Efs, Xu^Efs, Xu^Efs, Xu^Efs, Xu^Efs, Xu^Efs, Xu^Efs, Xu^Efs, Xu^Efs, Xu^Efs, Xu^Efs, Xu^Efs, Xu^Efs, Xu^Efs, Qxua^Ii, Qxua, Qxua, Qxua, Qxua, Urb^Edb, Urb, Urb, Qxua, Qxua, Qxua, Qxua, Qxua, Qxua, Urb, Urb, Qxua, Qxua, Qxua, Qxua, Qxua, Xu^Efs, Xu^Efs, Xu^Efs, Xu^Efs, Xu^Efs
