Qxua, Qxua, Qxua, Qxua, Qxua, Qxua, Qxua^Ii, Urb^Ii, Urb^Ii, Urb, Urb, Urb, Qxua, Qxua, Qxua, Qxua, Qxua, Qxua, Qxua, Qxua, Qxua, Qxua
Qxua, Qxua, Qxua, Qxua, Qxua, Qxua, Qxua, Qxua, Urb^Ii, Urb, Urb, Urb, Urb, Qxua, Qxua, Qxua, Qxua, Qxua, Qxua, Qxua, Qxua, Qxua
Qxua, Qxua, Qxua, Qxua, Qxua, Qxua, Qxua, Qxua, Qxua, Urb^Ii, Urb, Urb, Urb, Urb, Qxua, Qxua, Qxua, Qxua, Qxua, Qxua, Qxua, Qxua
Qxua, Qxua, Qxua, Qxua, Qxua, Qxua, Qxua, Qxua, Qxua, Urb^Edb, Urb, Urb^Edb, Urb, Qxua, Qxua, Qxua, Qxua, Qxua, Qxua, Qxua, Qxua, Qxua
Qxua, Qxua, Qxua, Qxua, Qxua, Qxua, Qxua, Qxua, Qxua, Urb^Edb, Urb^Edb, Urb^Edb, Urb, Qxua, Qxua, Qxua, Qxua, Qxua, Qxua, Qxua, Qxua, Qxua
Qxua, Qxua, Qxua, Qxua, Qxua, Qxua, Qxua, Qxua, Urb^Edb, Urb^Edb, Urb, Urb, Qxua, Qxua, Qxua, Qxua, Qxua, Qxua, Qxua, Qxua, Qxua, Qxua
Qxua, Qxua, Qxua, Qxua, Qxua, Qxua, Qxua, Urb^Edb, Urb^Edb, Urb^Edb, Urb, Urb^Ii, Qxua, Qxua, Qxua, Qxua, Qxua, Qxua, Qxua, Urb, Urb^Edb, Urb
Qxua, Qxua, Qxua, Qxua, Urb^Edb, Qxua, Qxua^Ii, Urb, Urb^Edb, 2 Urb, Urb, Urb, Urb, Qxua, Qxua, Qxua, Qxua, Qxua, Urb^Edb, Urb^Edb, Qxua, Qxua
Qxua, Qxua, Qxua, Qxua, Urb^Edb, Urb^Edb, Urb, Urb, Urb, Urb^Edb, Urb^Edb, Urb, Urb, Urb, Urb^Edb, Urb, Urb^Edb, Urb^Edb, Urb^Edb, Qxua, Qxua, Qxua
Urb, Qxua, Urb^Edb, Urb^Edb, Urb^Edb, Urb^Ii, Urb^Ii, Urb^Ii, Urb^Ii, Urb, Urb, Urb, Urb, Urb^Edb, Urb^Ii, Urb^Edb, Urb, Urb^Edb, Qxua, Qxua, Qxua, Qxua
Urb, Urb, Urb, Urb^Edb, Urb, Urb, Qxua, Qxua, Urb^Ii, Urb, Urb, Urb, Urb, Urb, Urb, Urb, Urb, Urb, Urb, Qxua, Qxua, Qxua
Urb, Urb, Urb, Urb^Edb, Urb^Edb, Qxua, Qxua, Qxua, Qxua, Qxua, Urb, Urb, Urb, Qxua, Urb, Urb, Urb^Edb, Urb, Urb^Edb, Qxua, Urb, Urb
Urb, Urb, Urb, Qxua, Qxua, Qxua, Qxua, Qxua, Qxua, Qxua, Urb^Edb, Urb^Ii, Qxua, Qxua, Qxua, Urb, Qxua, Urb^Edb, Urb, Urb, Urb, Urb
Qxua, Urb, Qxua, Qxua, Qxua, Qxua, Qxua, Qxua, Qxua, Urb^Edb, Urb, Urb^Ii, Qxua, Qxua, Qxua, Qxua, Urb^Edb, Urb^Edb, Qxua, Urb, Urb, Urb
Qxua, Qxua, Qxua, Qxua, Qxua, Qxua, Qxua, Qxua, Qxua, Urb^Edb, Urb, Urb^Ii, Urb^Ii, Qxua, Qxua, Urb^Edb, Urb^Edb, Qxua, Qxua, Qxua, Urb, Urb
Qxua, Qxua, Qxua, Qxua, Qxua, Qxua, Qxua, Qxua, Urb^Ii, Urb^Edb, 1 Urb, Urb, Urb, Qxua, Qxua, Qxua, Qxua, Qxua^Ii, Qxua, Qxua, Qxua, Qxua
Qxua, Qxua, Qxua, Qxua, Qxua, Qxua, Urb^Edb, Urb, Urb, Urb, Urb, Urb, Urb, Urb, Qxua, Qxua, Urb^Edb, Qxua^Ii, Qxua^Ii, Qxua, Qxua, Qxua
Qxua, Qxua, Qxua, Qxua, Urb^Edb, Urb^Edb, Urb^Edb, Urb^Edb, Urb, Urb, Qxua, Urb, Qxua, Urb^Edb, Urb^Edb, Urb^Edb, Urb^Edb, Urb^Edb, Urb^Edb, Urb, Urb^Edb, Urb
Qxua, Qxua, Urb, Qxua, Urb^Edb, Urb, Urb^Edb, Urb, Qxua, Qxua, Qxua, Qxua, Qxua, Urb, Urb, Urb^Edb, Urb, Urb, Urb^Edb, Urb^Edb, Urb, Urb^Edb
Urb, Urb, Urb^Ii, Urb^Edb, Urb^Edb, Urb^Edb, Urb, Urb^Edb, Qxua, Qxua, Qxua, Qxua, Qxua, Qxua, Qxua, Qxua, Urb, Urb^Ii, Qxua, Urb, Qxua, Urb
Urb, Urb^Ii, Qxua, Urb^Ii, Qxua, Qxua, Urb, Urb^Edb, Qxua, Qxua, Qxua, Qxua, Qxua, Qxua, Qxua, Qxua, Qxua, Qxua, Qxua, Qxua, Qxua, Qxua
Urb, Urb, Qxua, Qxua, Qxua^Xo, Qxua, Qxua, Qxua, Qxua, Qxua, Qxua, Qxua, Qxua, Qxua, Qxua, Qxua, Qxua, Qxua, Qxua, Qxua, Qxua, Qxua
